Title	Author	Year	Callnum
Analisis perbandingan metode coaching think aloud protocol dan silent condition terhadap goal dari user-centered design: studi kasus pada aplikasi clodeo	Arra Adidaya	2014	SK-1223
Pendeteksian gempa berbasiskan sensor accelerometer pada smartphone dengan pengolahan sinyal frekuensi dan pemelajaran mesin	Hafizh Kalamullah	2014	SK-1224
Algoritma load balance sederhana pada access point jaringan nirkabel IEEE 802.11G	Yahya Muhammad	2013	SK-1193
Analisis dampak knowledge sharing menggunakan knowledge management system pada efektivitas, efisiensi, dan inovasi: studi kasus Bank Indonesia	Rizal Pahlevi	2013	SK-1129
Analisis dan pengukuran tingkat kematangan dari pengimplementasian keamanan informasi: studi kasus perusahaan penyedia layanan telekomunikasi XYZ di Indonesia	Aina Kemala	2013	SK-1159
Analisis faktor kesuksesan dalam pengadopsian dan pengimplementasian sistem ERP di institusi penelitian: studi kasus badan tenaga nuklir nasional (BATAN)	Habibul Rafur	2013	SK-1215
Analisis faktor pengaruh kepuasan dan adopsi masyarakat terhadap implementasi e-government di kota Depok	Joyend	2013	SK-1157
Analisis faktor-faktor organisasi yang mendorong partisipasi pegawai dalam communities of practice  (COP) dan dampaknya terhadap kinerja individu, komunitas, dan organisasi : studi kasus PT PLN (PERSERO) distribusi Jakarta Raya dan Tangerang	Samuel Rizal Harahap	2013	SK-1149
Analisis faktor-faktor penerimaan computer-assited audit tools and techniques (CAATT) pada auditor eksternal menggunakan perluasan technology acceptance model (TAM)	Nina Meilatinova	2013	SK-1147
Analisis faktor-faktor yang mempengaruhi anggota komunitas virtual melakukan knowledge sharing: studi kasus komunitas online teknologi informasi di Indonesia	Arieffender Limupa	2013	SK-1150
Analisis faktor-faktor yang mempengaruhi kepercayaan konsumen terhadap e-commerce dan s-commerce di indonesia dan dampaknya terhadap keinginan konsumen untuk membeli serta word of mouth	Arfian Herbowo	2013	SK-1154
Analisis forecasting untuk data penjualan menggunakan metode simple moving average dan single exponental smoothing: studi kasus PT Guna Kemas Indah	Venezia Ryanka Sutrisno	2013	SK-1161
Analisis hubungan implementasi knowledge management terhadap peneliti pada lembaga penelitian : studi kasus Lembaga Penelitian : Studi Kasus Lembaga Ilmu Pengetahuan Indonesia (LIPI)	Radityo Shaddiqa	2013	SK-1103
Analisis hubungan kostomisasi sistem ERP dengan kesuksesan implementasinya : studi kasus PT. ABC	Dinur Rahmani Sadat	2013	SK-1104
Analisis hubungan strategi manajemen pengetahuan terhadap inovasi serta dampaknya pada kinerja usaha mikro kecil menengah di Indonesia	Dewangga Wisnu	2013	SK-1135
Analisis karakteristik cloud computing dan tingkat kematangan infrastruktur TI Universitas Indonesia	Arif ALhadi Putra	2013	SK-1108
Analisis karakteristik sistem pembayaran terhadap intensi perilaku konsumen untuk melakukan pembayaran online pada e-commerce si Indonesia	Luqman Syauqi Hidayat	2013	SK-1102
Analisis kesiapan jaringan universitas indonesia dalam implementasi voice over wireless local area network dengan pengamatan pada Fakultas Ilmu Komputer Universitas Indonesia	Ricky Artantio	2013	SK-1138
Analisis kinerja aplikasi klasifikasi support vector machine paralel pada lingkungan cluster dan graphics processing unit (GTX 465, GTX 470, GTX 560, dan QUADRO 4000)	Habiburrahman	2013	SK-1179
Analisis kinerja recurrent neural network, N-gram markov model, serta interpolasinya untuk membangun language model	Monica	2013	SK-1120
Analisis kinerja supply chain pada PT XYZ yang di dukung oleh sistem ABC dengan model SCOR, metode entropy, dan metode topsis	Dhea Junestya Pradipta	2013	SK-1213
Analisis knowledge management solutions dan implementasi knowledge management technology pada firma hukum: studi kasus firma hukum XYZ	Anggi Aida Budaya	2013	SK-1160
Analisis knowledge sharing bottlenect dengan menggunanak pendekatan social network analysis: studi kasus divisi IT/IS development PT X.	Kurnia Dara Mutia	2013	SK-1106
Analisis kualitas usr experience pada responsive web design dalam aspek informatif	RR. Devita Mira Lestari	2013	SK-1127
Analisis model manajemen inventori untuk perusahaan penyedia jasa konstruksi dan integrasi sistem: studi kasus PT Mitra Sinergi Adhitama	Stephanie Maria	2013	SK-1142
Analisis peluang keberhasilan implementasi knowledge management dengan menggunakan metode fuzzy multi-criteria decision making: studi kasus PT Altrovis Tekno Global	Marissa	2013	SK-1139
Analisis penerimaan teknologi internet oleh pengajar dengan menggunakan model unified theory of acceptance and use of technology (UTAUT)	Cholila Djavad Nammah	2013	SK-1141
Analisis pengaruh faktor-faktor teknologi terhadap perilaku web revisit pengguna pada portal berita online di Indonesia	Adrianda Putra	2013	SK-1145
Analisis pengaruh keterlibatan virtual community dalam pengembangan produk baru perusahaan: studi kasus gantibaju.com dan thinkcookcook.com	Suciwati Nursiam	2013	SK-1148
Analisis penilaian risiko keamanan untuk aset informasi pada usaha kecil dan menengah bidang finansial B2B: studi kasus NGATURDUIT.com	Anita Wulansari	2013	SK-1151
Analisis penjaminan kualitas sistem informasi zakat (SIZAKAT) melalui software testing	Abdul Haris	2013	SK-1166
Analisis performa strategi replikasi dan pencarian dokumen dalam sistem peer-topeer yang memanfaatka konsep lokalitas dan popularitas dokumen	Muhammad Rezqi	2013	SK-1165
Analisis persepsi privasi pada pengguna facebook di Indonesia	Muhammad Iqbal Perdana	2013	SK-1132
Analisis proses pengelolaan manajemen pengetahuan berdasarkan contingency view dengan studi kasus badan tenaga nuklir nasional (BATAN)	Ananda Cikal Asadera	2013	SK-1134
Analisis risiko untuk perencanaan kebijakan keamanan informasi berdasarkan information security management system (ISMS) ISO 27001: studi kasus pengelola nama domain internet indonesia (PANDI)	Mutmainah	2013	SK-1130
Analisis sentimen berbasis aspek menggunakan latent dirchlet allocation, clustering validation, dan aggregate opinion	Omar Abdillah	2013	SK-1198
Analisis userexperience pada aplikasi mobile spreadsheet dengan pendekatan aspek usability	Wanda Kinasih	2013	SK-1131
Aplikasi penemuan kembali password untuk sistem operasi windows	Tozza Lantika Riyanto	2013	SK-1116
Desain interaksi aplikasi real-time ridesharing untuk mengurangi kemacetan di daerah Jakarta	Andika Amri	2013	SK-1216
Deteksi dan tracking objek secara autonomous dengan quadcopter AR.DRONE	Futuhal Arifin Annasri	2013	SK-1184
Ekspansi leksikon dan modifikasi fungsi evaluasi semantik pada pembuat puisi otomatis	Feraena Bibyna	2013	SK-1112
Eksplorasi constructive quality model (coqualmo) dan penerapnnya pada proyek pengembangan perangkat lunak di PT EIC	Yulindo	2013	SK-1203
Eksplorasi protocol USB pada implementasi driver keyboard dengan sensor touch menggunakan AVR ATXMEGA 256 A3BU	Fajri	2013	SK-1114
Ekstraksi isi halaman web menggunakan metode content extraction via text density (CETD)	Rangga Hadisurya	2013	SK-1172
Estimasi lokasi dan klasifikasi kondisi lalu lintas berdasarkan hasil ekstraksi dari media sosial twitter	Rachmad Akbar	2013	SK-1221
Evaluasi dampak implementasi knowledge management system di Bank Indonesia pada Aspek People	Handre Duriana	2013	SK-1155
Evaluasi kesiapan proses manajemen layanan TI (manajemen tingkat layanan dan manajemen insiden) dengan menggunakan kerangka pemetaan ISO/IEC 20000 dan cobit: studi kasus pengelola nama domain internet indonesia (PANDI)	Silvia Anggraeni	2013	SK-1208
Evaluasi trust pada situs web e-commerce Indonesia	Sri Wahyuni	2013	SK-1146
Faktor-faktor adopsi mobile government di Indonesia: studi kasus layanan aspirasi dan pengaduan online rakyat (LAPOR!)	Ferdy Alfarizka Putra	2013	SK-1144
Faktor-faktor kualitas informasi pada jenjaring sosial  dan official website yang mempengaruhi keputusan untuk melakukan perjalanan wisata menurut perspektif backpacker di Indonesia	Rizka Eka Putri	2013	SK-1105
Implementasi algoritma clustering hirarkis secara agglomerative dengan pembatas kesebelahan pada data tingkat kesejahteraan penduduk	Dony Novrianto	2013	SK-1219
Implementasi algoritma decision tree C4.5 dalam penentuan jumlah zakat mustahik pada sistem informasi zakat (SIZAKAT)	David Bayu Ananda	2013	SK-1167
Implementasi algoritma pendeteksian perubahan cluster secara otomatis dengan menggunakan self-organizing MAP pada data temporal	Pandu Wicaksono	2013	SK-1174
Implementasi anotasi otomatis data audio menggunakan pendekatan recaptcha basis audio	Andry Luthfi	2013	SK-1206
Implementasi cluster computing berbasiskan cloud dengan middleware rocks	Ardhi Putra Pratama	2013	SK-1183
Implementasi dan pengembangan NFCAFE: aplikasi mobile android berbasis NFC untuk sistem transaksi jual beli di lingkungan kantin	Fikrul Arif Nadra	2013	SK-1189
Implementasi fungsi pemanggilan IOCTL untuk pengelolaan tabel routing pada modul ATN di atas kernel linux	Husein Muhammad Mufti	2013	SK-1199
Implementasi knowledge management system pada lembaga riset studi kasus laboratorium digital library and distance learning Fakultas Ilmu Komputer Universitas Indonesia	Muhammad Teguh Brillian	2013	SK-1222
Implementasi logika fuzzy pada pengolahan konteks indikator cuaca untuk menentukan tingkat kenyamanan penghuni: studi kasus rumah cerdas	Hein Dewantara	2013	SK-1186
Implementasi metode higher order mutation dan analisis efek pemilihan mutation operator pada mutation testing untuk bahasa C	Rizki Amelia	2013	SK-1109
Implementasi modul analisis lokasi di halaman rancang bangun rumah cerdas dengan projective transformation	Galih Andy Pradana	2013	SK-1177
Implementasi modul dan analisis efektivitas penilaian kinerja pegawai bagi manajemen rumah sakit: studi kasus rumah sakit kanker Dharmais	MUhammad Rif'at Syauqi	2013	SK-1214
Implementasi modul sinkronisasi tabel routing antar ATN intermediate system menggunakan protokol IS-IS di atas framework quagga	Pulung Ragil Lanang	2013	SK-1204
Implementasi non-blind deconvolution pada gambar astronomis tunggal dengan matlab	Lukmanul Hakim	2013	SK-1111
Implementasi wireless remote control standar IEE 802.15.4 untuk meteran listrik prabayar	Firza Agusta Wiratama	2013	SK-1201
Klasifikasi dokumen teks berdasarkan subject headings dengan algoritma naive bayes dan support vector machine serta pengaruh dokumen unlabeled pada klasifikasi	Panji Yudha Satriawan	2013	SK-1175
Klasifikasi topik pada microblog berbahasa indonesia	Timotius Nico	2013	SK-1173
Konsumsi data semantic pada portal evaluasi akademik perguruan tinggi jenjang sarjana (studi kasus Universitas Indonesia)	Krishna Priawan Hardinda	2013	SK-1196
Mesin penerjemah statistik berfaktor menggunakan informasi part-of-speech, morfologi dan lemma pada corpus parallel Inggris-Jerman dan Inggris-Indonesia	Darryl Yunus Sulistyan	2013	SK-1115
Metode MRF dan MAP untuk pencitraan super resolusi pada citra tunggal	Prildy	2013	SK-1113
Pemetaan laporan penelitian dan paper dengan menggunakan metode vector space model	Ika Novianty	2013	SK-1176
Pemilihan metode peramalan deret waktu menggunakan classification based on associations dan decision tree	Julian Trifany Ananda Tirta	2013	SK-1212
Pemodelan basis data rekam medis elektronik untuk rumah sakit pendidikan studi kasus RSUPN DR. Cipto Mangunkusumo	Rezky Ramadiansyah	2013	SK-1210
Penerapan business intelligence sebagai alat bantu manajemen proyek untuk pemantauan efisiensi kinerja pada organisasi berbasis proyek konstruksi: studi kasus PT Mitra Sinergi Adhitama	Tri Nurdin Anthony Situmorang	2013	SK-1140
Penerapan kerangka kerja SNI ISO/IEC 27001: 2009 dan NIST SP 800-53 revisi 4 untuk audit keamanan informasi: studi kasus lembaga pemerintahan XYZ	Herdiansyah Rhamadan	2013	SK-1207
Penerapan kerangka kerja sarbanes oxley dalam audit teknologi informasi: studi kasus perusahaan manufaktur XYZ di Indonesia	Ryan Wiji Ageng Bestari	2013	SK-1158
Penerapan metode extreme learning machine untuk megklasifikasi fase pertumbuhan tanaman padi berdasarkan data hiperspektral dan modis	Nugroho Suhandono	2013	SK-1121
Penerapan model kesesuain adopsi cloud misra mondal dan pengembangan kerangka kerja pemilihan tipe cloud deployment yang sesuai di institusi pemerintah menggunakan pendekatan BCOR, ENTROPI dan TOPSIS	Ghilman Fatih	2013	SK-1137
Penerapan model pemrograman mapreduce untuk meningkatkan performa  pemrosesan query pada basis data NOSQL	Mochammad Tri Rahmady	2013	SK-1153
Penerapan pengelompokan dokumen untuk mengatasi masalah ambigu pada pencarian orang	Amanah Ramadiah	2013	SK-1194
Pengaruh electronic word-of-mouth terhadap consumer purchase decision pada aktivitas e-commerce dari perspektif consumer characteristic di kalangan mahasiswa indonesia	Maria Analia Vinesta Sinaga	2013	SK-1152
Pengaruh kualitas e-government terhadap kepercayaan masyarakat dan dampaknya terhadap keinginan untuk berpartisipasi dan electronic WORD OF MOUTH	Rizqa Nulhusna	2013	SK-1209
Pengembagan sistem informasi pengelolaan kinerja pegawai di PT United Tractors TBK	Syaiful Huda	2013	SK-1143
Pengembangan DBPEDIA Indonesia	Riko Adi Prasetya	2013	SK-1180
Pengembangan Enterprise Resource Planning (ERP) untuk sektor usaha mikro kecil menengah (UMKM) pada area fungsi bisnis sales	David	2013	SK-1117
Pengembangan aplikasi Z-wave di atas platform android dengan porting library open Z-wave ke java menggunakan USB host API	Ida Bagus Putu Peradya Dinata	2013	SK-1192
Pengembangan data mining workbench berbasis komputasi awan	Esteria Soplantila	2013	SK-1122
Pengembangan fitur preprocessing dan visualisasi pada FIKUI miner berbasis komputasi awan	Nanda Arta	2013	SK-1202
Pengembangan learning environment penerapan enterprise service bus pada perkuliahan enterprise application integration	Mohamad Andriyan	2013	SK-1170
Pengembangan ontologi evaluasi akademik internal perguruan tinggi studi kasus Universitas Indonesia	Iis Afriyanti	2013	SK-1190
Pengembangan ontologi semantic web berbasis description logic untuk aplikasi e-CHNH (e-cultural) heritage and natural history)	Faiq Miftakhul Falakh	2013	SK-1171
Pengembangan perangkat konversi protokol Z-wave menjadi UPNP: studi kasus rumah cerdas	Wendra	2013	SK-1182
Pengembangan perangkat object realtional mapping (ORM) sebagai jembatan antara pemrograman berorientasi objeck dan basis data relasional	Nofa Aulia	2013	SK-1168
Pengembangan prototipe perangkat routing untuk aeronautical telecommunication network	Abi Rheza Nasa'i	2013	SK-1123
Pengembangan prototype sistem enviar mobile dalam virtualisasi informasi wireless sensor network dengan representasi augmented reality berbasis lokasi	Hafizh Hasrindra	2013	SK-1200
Pengembangan sistem keamanan ruang pribadi berbasiskan konteks menggunakan logika fuzzy: studi kasus rumah cerdas	Yulistiyan Wardhana	2013	SK-1197
Pengembangan sistem telehealth pertumbuhan janin (Terrain) berbasiskan deteksi pada citra kepala janin ultrasonografi dua dimensi	Roberth Rahmatullah	2013	SK-1218
Penggunaan model dematel untuk menentukan faktor-faktor manfaat, peluang, biaya, dan risiko yang mempengaruhi adopsi teknologi cloud: studi kasus pada perusahaan jasa pertambangan skala menengah dan besar	Nathan	2013	SK-1162
Penghitungan indeks PAR (peer assessment rating) pada citra model gigi 2D untuk koponen penilaian jarak gigit, gigitan terbuka, dan segmentasi gigi pada model gigi terbuka	Muhammad Febrian Rachmadi	2013	SK-1220
Pengujian pemetaan taksonomi pengetahuan pada lembaga penelitian nuklir menurut pandangan pakar: studi kasus badan tenaga nuklir nasional (BATAN)	Aridya Maharianto	2013	SK-1133
Penyaringan materi berbahaya dengan memanfaatkan fitur dari dokumen web menggunakan metode naive bayes dan K-nearest neighbours	Fitri Nurinsani Rachbini	2013	SK-1185
Perancangan surface gesture untuk 3D manipulation dengan metode participatory design	Muhammad Husein	2013	SK-1156
Perancangan user experience guidelines untuk aplikasi alat musik plano dalam device tablet	Ikhma Hariyanti	2013	SK-1205
Perbandingan kinerja TCP dan UDP pada IPV4 dan IPV6	Indra Ferry	2013	SK-1136
Perbandingan metode maximum LIKELIHOOD, random forest, dan neural network untuk klasifikasi pada fusi citra lidar dengan citra optik udara	Remmy August Menzata	2013	SK-1181
Perbandingan user experience ketika bernavigasi antara desain toggle menu dan top navigation menu pada mobile website melalui perangkat touchscreen	Febriya Hotriati Psalmerosi	2013	SK-1187
Prediksi harga saham ASII menggunakan jaringan syaraf tiruan	Muhammad Irfan	2013	SK-1191
Proses pengembangan sistem basis data menggunakan basis data berbasis document-store dan perbandingannya dengan proses pengembangan menggunakan basis data relasional	Raden Agung Yuga Dwitama	2013	SK-1169
Prototype sistem integrasi pendeteksian dini dan monitoring penyakit jantung berbasis sinyal elektrokardiogram	Muhamamd Anwar Ma'sum	2013	SK-1110
Rancangan model sistem informasi rumah sakit pendidikan: studi kasus RSUPN DR.Cipto Mangukusumo	Dinda Paramitha Wahyudi	2013	SK-1211
Simulasi byzabtine generals problem di sequence diagram dengan menggunakan ABS (Abstract behavioral specification)	Nur Ululasman	2013	SK-1217
Sistem fully homomorphic encryption gentry-halevi yang berdasarkan ideal lattice dan implementasinya menggunakan bahasa pemrograman sage	Hadi Saputro	2013	SK-1195
Sistem pembangkit puisi otomatis untuk bahasa indonesia menggunakan pendekatan constraint satisfaction problem	Fam Rashel Putraruddy Scala	2013	SK-1178
Skema Fully homomorphic encryption gentry versi integer dan implementasinya dengan menggunakan bahasa pemrograman python	Prahesa Kusuma Setia	2013	SK-1164
Theorem proving untuk linear logic dan implementasinya dalam prolog	Satyadharma Tirtarasa	2013	SK-1163
Traffic information gathering: estimasi jumlah kendaraan dan kecepatan kendaraan dan kecepatan kendaraan pada malam hari menggunakan kamera tunggal	Ibnu Sina	2013	SK-1188
Analisa kinerja address resolution protocol spoofing	Teofilus G.S.	2012	SK-1069
Analisis dampak dari penerapan sistem e-procurement serta tingkat kematangannya pada PT. PLN (Persero)	Yuanisa Ditari	2012	SK-1000
Analisis dan evaluasi algoritma insert dan delete modul BTRFS pada sistem operasi GNU/LINUX	Ikhwanur Septiadi	2012	SK-1060
Analisis dan pengukuran tingkat kematangan implementasi keamanan informasi di Perusahaan : studi kasus PT XYZ	Tommy Kurniawan	2012	SK-1035
Analisis dan perancangan sisten enterprise resource planning pada fungsi bisnis production management: studi kasus usaha mikro kecil dan menengah	Ahmad Mahmudi Yunus	2012	SK-1047
Analisis fase dan persepsi karyawan terhadap knowledge sharing pada perusahaan konsultan TI	Ika Chandra Hapsari	2012	SK-1036
Analisis fitur Electronic Document Management System (EDMS) untuk aplikasi Customer Relationship Management (CRM) - sales force automation berdasarkan aktivitas proses penjualan	Ernita Fauzia	2012	SK-1055
Analisis fitur Electronic Document Management System (EDMS) untuk aplikasi Customer Relationship Management (CRM) - service automation pada kegiatan problem complain	Evita Yustia	2012	SK-1054
Analisis fitur electronic customer relasionship management (E-CRM) pada layanan internet banking : studi kasus  bank XYZ	Ulil Amri Kamili	2012	SK-1083
Analisis fitur media social dalam mendukung peningkatan interaksi dan hubungan dengan pelanggan pada  e-commerce b2c: studi kasus BLIBLI.COM	Noor Rahmanto Ragil Utomo	2012	SK-1051
Analisis fungsionalitas customer relasionship management pada modul marketing automation untuk destination management system: studi kasus XYZCOM	Yessica Sari	2012	SK-1044
Analisis fungsionalitas modul sales force automation dan service automation pada aplikasi customer relationship management untuk destination management system: studi kasus XYZ.com	Putri Khusnus Khotimah	2012	SK-1042
Analisis human motion berbasis principal component analysis dan dynamic time warping menggunakan kinect	Vega Prima Sagitara	2012	SK-1080
Analisis keselarasan bisnis dan teknologi informasi di PT Aplikanusa Lintasarta	Yuni Wulandari	2012	SK-1017
Analisis kesenjangan antara tujuan yang ingin dicapai dan software requirement saat ini menggunakan metode goal-oriented requirement engineering (GORE) dan pendekatan KAOS: studi kasus sistem SPD online PT Rekayasa Industri	Itsna Imroatus Sholihah	2012	SK-1096
Analisis kinerja aplikasi amber pada lingkungan komputasi cluster dan graphics processing unit	Aruni Yasmin Azizah	2012	SK-1052
Analisis kualitas layanan pelanggan elektronik dan penggunaan social media monitoring tool dalam mendukung aktifitas layanan pelanggan melalui media social: studi kasus PT XZY	Febrian Shandy Rifano	2012	SK-1040
Analisis kualitas layanan teknologi informasi serta tingkat kematangan tata kelola manajemen insiden dan service desk: studi kasus PT. Asuransi Astra Buana	Fitria Ratna Mutia	2012	SK-1031
Analisis lanjut sistem penilai esai otomatis pada konteks soal subyektif dan obyektif menggunakan korpus multi bahasa dengan metode latent semantic	Jessalyn Alvina	2012	SK-???
Analisis manfaat risiko dan tingkat kematangan pada penyedia layanan cloud computing software-as-a-service: studi komparasi antara penyedia layanan bertipe pure-saas dan mixed-saas	Akhmad Rahadian Hutomo	2012	SK-1021
Analisis masalah sparse data dalam spasial dan temporal clustering : studi kasus pada data permohonan pengaktivasian layanan internet	Christian	2012	SK-1118
Analisis model bisnis pada penyedia layanan cloud computing software-as-service: studi komparasi antara penyedia layanan bertipe pure-saas dan mixed saas	Indra Hardianto	2012	SK-1039
Analisis pencapaian manfaat dan tingkat kematangan terhadap implementasi customer relationship management: studi  kasus pada PT XYZ	Alfira Fitrananda	2012	SK-1033
Analisis penerapan keranga  kerja small to medium entity risk assessment model (SMERAM) dalam melakukan IT Risk Assessment di Bank Perkreditan Rakyat (BPR)	Grafit Dwiananto	2012	SK-1038
Analisis pengaruh budaya organisasi terhadap tingkat kematangan keselarasan strategi teknologi informasi dan bisnis: studi kasus PT. Taspen (PERSERO)	Gayuh Prima Pikarti	2012	SK-989
Analisis pengaruh faktor kepercayaan dan faktor kekhawatiran terhadap persepsi resiko konsumen dalam melakukan transaksi secara online di Indonesia	Hamzah Saifulhaq	2012	SK-1099
Analisis pengaruh kompresi suara menggunakan speex terhadap akurasi hasil pengenalan suara menggunakan sistem pengenal suara otomatis bahasa indonesia	Adriani S. Zenitha	2012	SK-1053
Analisis pengaruh media social terhadap e-commerce	Grinano Ardhi Wibowo	2012	SK-1084
Analisis penggunaan manajemen pengetahuan pelanggan (Customer knowledge management) dalam proses pengembangan produk baru: studi kasus PT. XL Axiata, Tbk	Fehmi Rahmita	2012	SK-1050
Analisis pengukuran kualitas informasi dan tingkat kematangan manajemen kualitas informasi: studi kasus PT. XYZ (Persero)	Nur Fitriah Ayuning Budi	2012	SK-1027
Analisis sentiment produk dan layanan menggunakan social media data pada corporate twitter: studi kasus perusahaan seluler XYZ	Windy Adam	2012	SK-1043
Analisis strategy-driven web based business intelligence menggunakan top-down approach: studi  kasus implementasi business intelligence dashboard pada PT. Rekan Usaha Mikro Anda	Danny Handoko	2012	SK-1066
Analisis tingkat kematangan human-centeredness dalam system development: studi kasus Pusat Ilmu Komputer Universitas Indonesia	Elvira Novellia Chrisanty	2012	SK-992
Analisis tingkat kematangan manajemen risiko TI pada perbankan di Indonesia dengan kerangka kerja RISK IT: studi kasus pada Bank XYZ	Adinda Dwisetyorini	2012	SK-991
Analisis tingkat kematangan serta identifikasi faktor pendukung dan penghambat business intelligence di industri telekomunikasi indonesia: studi kasus PT Bakrie Telekom, Tbk	Adzar Karomy	2012	SK-1100
Analisis tingkat kesuksesan dan factor pendukung penerapan IT outsourcing: studi kasus PT. Bank Bukopin Tbk	Rizqy Puspitasari	2012	SK-1041
Analsis e-readiness pada UMKM di  wilayah Depok dan Bogor	Kamal Hasan	2012	SK-1107
Aplikasi algoritma spasial dan temporal clustering pada data curah hujan	Wawan Setiawan	2012	SK-1071
Aplikasi teori sinyal pada e-commerce marketing channel: pengaruh persepsi kualitas website universitas terhadap persepsi kualitas pendidikan dan intensi pendaftyaran universitas 	Fanny Rofalina	2012	SK-1020
Audit keamanan teknologi informasi (TI) dengan menggunakan control objektive pada kerangka cobit 4.1: studi kasus Fakultas Ilmu Komputer (FASILKOM) Universitas Indonesia	Arnold Rafles Fansius	2012	SK-1085
Audit kelayakan data center dengan menggunakan standar ANSI/TIA-942 2005 pada aspek telekomunikasi dan mekanika: studi kasus pemerintah provinsi XYZ	Nurindro Danu Wicaksono	2012	SK-1001
Design dan implementasi dari RPG quest generator menggunakan konsep world state dan rule sebagai contraint dari cerita	Eduar Napoleon	2012	SK-1098
Deteksi dan pengenalan wajah jamak untuk studi awal sistem presensi otomatis	Mira Roderica	2012	SK-990
Identifikasi alat musik tradisional indonesia dengan memanfaatkan fitur mel-frequnecy cepstral coefficients (MFCC) pada musik poliponik	Chairunissa Atimas Nurahmad	2012	SK-999
Identifikasi knowledge management governance serta analisis tingkat kematangan manajemen pengetahuan:  studi kasus pada PT. Federal International Finance	Fathiya Achmad	2012	SK-1025
Identifikasi manusia berdasarkan profil DNA orangtua dan saudara kandung menggunakan sistem inferensi fuzzy	Tirmidzi Faizal Aflahi	2012	SK-995
Identifikasi penyanyi pada musik polifonik	Kenanya Gusti Markarya	2012	SK-1078
Identifikasi tingkat keamanan sistem electronic voting dengan menggunakan model electronic voting system security optimization: studi kasus lembaga XYZ	Ratih Malini	2012	SK-1090
Implementasi algoritma CART dengan teknik classification tree sebagai bagian dari data mining algorithm collectino	Aldrian Yudhistira	2012	SK-1074
Implementasi algoritma adaboost untuk peningkatan akurasi prediksi model dengan menggunakan algoritma C4.5 sebagai weak leaner	Tio  Pramayudi	2012	SK-1065
Implementasi algoritma collaborative filtering pada sistem rekomendasi di forum diskusi	Megawati	2012	SK-1087
Implementasi algoritma pemrosesan gambar dan GLVQ pada parrot AR.DRONE untuk menjejaki sebuah objek di lantai mengunakan kamera bawah	M. Nanda Kurniawan	2012	SK-1072
Implementasi algoritma position by line dengan sink localization pada robot Al-Fath untuk perluasan jaringan telekomunikasi di daerah bencana	M. Sakti Alvissalim	2012	SK-1007
Implementasi antar muka aplikasi data mining algorith collection dan modul prepocessing data	Yogi Kurnia	2012	SK-1058
Implementasi business intelligence sebagai alat monitoring proses bisnis dan bahan analisis dalam pengambilan keputusan strategis: studi kasus pusat resi gudang PT. Kliring Berjangka Indonesia	Aprilianto	2012	SK-1026
Implementasi contextual advertising menggunakan teknik vector space model dan latent semantic analysis	Istha Bena Hadirani	2012	SK-1093
Implementasi debugging tool pada behavior tree	Agung Pratama	2012	SK-1059
Implementasi generalized hough transform dengan edge points pairing pada graphics processing unit	Affath Firdausi	2012	SK-1097
Implementasi media sharing pada perangkat  bersistem operasi android dalam jaringan local berbasis UPNP	Bukhori Muhammad Aqid	2012	SK-1070
Implementasi monitoring indicator kinerja utama dengan pemanfaatan business intelligence: studi kasus Lembaga Kebijakan Pengadaan barang/jasa Pemerintah	Anastasia Octaviana Khrisna Dewi	2012	SK-1049
Implementasi pencarian pola sekuensial menggunakan algoritma generalized sequential pattern	Juliana Anita Galag	2012	SK-1057
Implementasi sponsored search menggunakan teknik BID PHRASE clustering	Yasmin Khairina	2012	SK-1068
Kajian manajemen risiko proyek dengan menggunakan kerangka kerja RASM: Studi Kasus Bank Indonesia	Lukman Satria	2012	SK-1028
Klasifikasi motif batik menggunakan metode scale invariant feature transform	Rina Akta	2012	SK-1073
Komparasi peningkatan mutu citra dokumen tua dengan metode a-rooting dan thresholding	Meliani Efelina Napitupulu	2012	SK-1024
Mendeteksi plagiarisme eksternal pada teks dengan deret interval sah	Lasguido	2012	SK-1019
Mengukur tingkat  severity, vulnerability, risk, trust, dan privacy pada penerapan keamanan sistem informasi : studi kasus PT XYZ	Anniesa Marshadiany	2012	SK-1034
Mesin penerjemah statistik dua arah untuk bahasa indonesia dan bahasa mandarin menggunakan dictionary-based lookup dan model penerjemahan berfaktor	Steffi Melinda	2012	SK-1005
Modifikasi tuxcut untuk mengatasi penyalahgunaan bandwidth dengan teknik ARP spoofing	Ahmad ALmaarif	2012	SK-1067
Pembentukan behavior tree dari representasi semantic software requirement dalam SOU-KIF	Adani Aristy	2012	SK-1061
Pembentukan multiresolution mesh untuk objek 3D dengan menggunakan 	Mega Denditya M.	2012	SK-1011
Pemetaan dan pengukuran kinerja dari fungsionalitas service automation pada unit customer service perusahaan telekomunikasi studi kasus: PT IndosatM2	Ryan Pradipta Putra	2012	SK-1048
Pencocokan citra panorama yang ditajamkan menggunakan metode lailin	Topan Bayu Kusuma	2012	SK-994
Pendekatan komputasi kuantum dalam penyelesaian sistem persamaan linear	Ikhsanul Habibie	2012	SK-1086
Pendekatan teknik Bag of features dengan kernel dimension education pada permasalahan klasifikasi citra	Silvia Winatan	2012	SK-997
Pendeteksian vesikel dalam citra fluorescence microscopy dengan metode adaboots dan fisher discriminant analysis	Shieron Antolis	2012	SK-1124
Penelitian dan pengembangan prototipe sistem point of sale berbasis web sebagai bagian dari Enterprise Resource Planning (ERP): Studi kasus Usaha Mikro Kecil Mengengah (UMKM)	Ruth Magdalena	2012	SK-1032
Penemuan jawaban dengan menggunakan mesin pembaca dokumen pada sistem tanya jawab	Philip Arthur	2012	SK-1119
Penerapan audit sistem informasi berbasis web dengan menggunakan pemetaan kerangka infauditor terhadap cobit 4.1: studi kasus Direktorat Jenderal Bina Marga Kementrian Pekerjaan Umum	Kartika Pratiwi	2012	SK-1030
Penetapan fungsionalitas service automation pada hospital information systems menggunakan konsep servqual: studi kasus rumah sakit haji Jakarta	Fatimah Azzahro	2012	SK-1037
Pengeimplementasian story planning dari sistem story generation picture books  sebagai sebuah knowledge base	Henry Loharja	2012	SK-1004
Pengembangan content management system (CMS) e-commerce dengan teknik search engine optimization (SEO) untuk mengoptimalkan visibilitas toko online pada hasil penelusuran  google	Purnadi Winarno	2012	SK-1022
Pengembangan dashboard indikator pembangunan pertanian sebagai informasi bagi eksekutif: studi kasus kementrian pertanian republik Indonesia	Fajar Pranata Siwi	2012	SK-1046
Pengembangan demeter sebagai aplikasi perangkat lunak pada sistem wireless sensor network bumi	Aditya Nugraha	2012	SK-1062
Pengembangan digital dashbboard sebagai komponen visualisasi dalam business intelligence untuk menampilkan informasi monitoring dan evaluasi: studi kasus pusat data dan informasi pertanian	Satrio Budhi	2012	SK-1092
Pengembangan fungsi evaluasi rima pada pembangkit puisi otomatis Mcgonagall	Mieke Eka Putri	2012	SK-1008
Pengembangan kerangka kerja dan analisa pengukuran tingkat kesiapan implementasi electronic customer relationship management organisasi: studi kasus pada perusahaan Start-UP	Latifah Helmy M	2012	SK-1029
Pengembangan kerangka kerja pengukuran tingkat kesiapan implementasi business intelligence pada organisasi: studi kasus mode fashion group	Robertus Kristianto	2012	SK-1010
Pengembangan materi baru pada sistem webgoat sebagai testbed untuk penetration testing terhadap keamanan sistem informasi dalam kerangka ethical hacking	Willy Halim Dinata	2012	SK-1016
Pengembangan pervasive computing berbasis wireless sensor network dengan standar IEEE 802.15.4/Zighee	Budiarto	2012	SK-1076
Pengembangan prototipe sistem transkripsi berbasis web secara crowdsourcing dengan penerapan prinsip human computer interaction	Maya Fitria	2012	SK-1094
Pengembangan prototype perangkat lunak enviar dalam virtualisasi informasi wireless sensor network pada aplikasi demeter dengan representasi augmented reality	Enggar Baskoro	2012	SK-1064
Pengembangan sistem pengenalan suara bahasa Indonesia untuk percakapan spontan	Kirana Widyastuti	2012	SK-1056
Pengembangan use case diagram generator dari software equirement specification dalam bahasa indonesia dengan menggunakan analisis semantik	Latifaah	2012	SK-1003
Pengkajian kinerja algoritma pendekodean pada sistem pengenalan suara otomatis bahasa indonesia	Angga Aditya	2012	SK-1088
Pengklasifikasian tipe pola sidik jari dengan metode berbasis gradien	Vici Riyani Tedja	2012	SK-996
Pengukuran manfaat pengimplementasian sistem ERP pada perusahaan manufaktur perkebunan studi kasus PT XYZ	Nita Arryani Sari	2012	SK-1014
Perancangan strategi dan user interface layanan online video sharing pada PT Beoscope dotkom	Siti Hapsari Dyahningrum	2012	SK-1023
Perbaikan BT2SAL translator untuk integrasi model checker dengan trace animator pada paradigm behavior engineering	Ardi	2012	SK-1081
Perbandingan algoritma klasifikasi jaringan syaraf tiruan dalam pendeteksian penyakit arrhythmia	Diane Fitria	2012	SK-1095
Perbandingan algoritma naive bayes dan algoritma chung-kwei dalam klasifikasi SMS SPAM berbahasa Indonesia dan bahasa Inggris	Miftahul Husni	2012	SK-1079
Perbandingan implementasi akksi individu umpan panjang dan umpan pendek pada autonomous robot soccer	Sony Wirawan	2012	SK-1089
Perbandingan troughput IPV4, IPV6 dan IPV6 dengan tuneling pada jaringan dengan ukuran MTU 1280 dan 1500 byte	A. Fakhrul Arrozi	2012	SK-998
Peringkasan dokumen berita dalam bentuk timeline	Meganingrum Arista Jiwanggi	2012	SK-1075
Peringkasan dokumen multi bahasa menggunakan pengelompokan dokumen	Michaela Nathania	2012	SK-1018
Prototipe pengamanan barang bukti digital pada computer forensic menggunakan metode partition hiding	Imam Bachtiar	2012	SK-1082
Rekonstruksi permukaan tiga dimensi dengan pendekatan visi stereo	Mohammad Agung Wibowo	2012	SK-1077
Simulasi pembentukan formasi dari robot quadcopter dalam melakukan eksplorasi ruangan menggunakan  perangkat lunak V-REP	Kharda Ahfa	2012	SK-1063
Sistem enkripsi berbasiskan identitas boneh-franklin yang memanfaatkan weil pairing dan implementasinya menggunakan bahasa pemrograman java	Radityo Eko Prasojo	2012	SK-1012
Steganografi citra berbasis transformasi wavelet dengan metode lifting	Sely Haudy	2012	SK-1009
Strategi manajemen perubahan untuk mendukung implementasi knowledge management system (KMS): studi kasus PT. Indonesia Telemedia (Telkomvision)	Irene Sherlyta Gloria	2012	SK-993
Studi keamanan aplikasi web institusi pendidikan menggunakan testing guide OWASP,  studi kasus: scele Fasilkom UI	Nestor Sar Naru	2012	SK-1045
Translation of specification in behavior tree to an executable abstract behavioral specification	Emerson Chan Simbolon	2012	SK-1101
Algoritma spatial-temporal clustering pada aplikasi basis data kriminal	Christian Regensius	2011	SK-944
Analisa sentimen menggunakan metode unsupervised classification: pointwise mutual information	Chipta Perdana	2011	SK-957
Analisis dampak diseminasi informasi pada media sosial dalam pegelolaan brand (brand management): studi kasus pada perusahaan Tendencies dan Locoshop	Winahyu Anggoro	2011	SK-1006
Analisis dampak pemasaran online tanpa berbayar menggunakan situs jejaring sosial  facebook: studi kasus pada perusahaan inspired 27 dan garlick store	Wahyu Lisdianingrum	2011	SK-913
Analisis dampak tangible dan itangible benefit pada implementasi enterprise resource planning (ERP) di perusahaan minyak dan gas bumi studi kasus PT XYZ	Aprilia Pratiwi	2011	SK-920
Analisis dan implementasi web service untuk pemenang pengadaan barang dan jasa secara elektronik berbasiskan soap dan rest	Annisa Nadya	2011	SK-918
Analisis dan perancangan protokol routing pada mobile robot sensor network untuk ekspansi area jaringan telekomunikasi secara otonomi di daerah bencana	Enrico Budianto	2011	SK-953
Analisis dan perumusan strategis pelaksanaan green it pada organisasi di indonesia beserta faktor pendukung dan penghambatannya	Rizqi Teguh Setiadi Hermawan	2011	SK-935
Analisis faktor-faktor yang mempengaruhi penerimaan pengguna dalam menggunakan sistem enterprise resource planning (ERP) studi kasus PT XYZ	Yulianti	2011	SK-903
Analisis fungsionalitas electronic-customer relationship management terhadap proses bisnis di lembaga konsultasi teknologi informasi XYZ	Ersalina Aritriztya	2011	SK-933
Analisis implementasi strategi multiple information security governance (ISG frameworks dan critical success factors implementasi ISG pada industri minyak bumi dan gas indonesia: studi kasus PT X	Wachid Yoga Afrida	2011	SK-919
Analisis kebutuhan fungsional dan pembuatan prototipe knowledge management system: studi kasus PT Dana pensiun Bank Negara Indonesia	Handika Masbudi	2011	SK-948
Analisis kebutuhan modul aplikasi SAP ERP (R/3) yang diperlukan untuk logistik militer: studi  kasus TNI angkatan darat	Yasril Sjaf	2011	SK-910
Analisis model knowledge management dalam organisasi IT support service dengan metodologi grounded theory dan teknik repertory grid: studi kasus IT Fasilkom UI	Alexander Agustinus	2011	SK-951
Analisis penggunaan dan pengelolaan corporate blog pada perusahaan konsultasi di Indonesia	Indah Nurul Aini Razaad	2011	SK-983
Analisis perancangan sistem enterprise application integration pada Fasilkom UI	Rahmat Kurniawan Kresnamurti	2011	SK-987
Analisis perbandingan clustering data ekspresi gen yang terintegrasi dengan menggunakan metdoe data consolidation dan transformasi kernel  	Fabian	2011	SK-909
Analisis perbandingan functionality dan nonfunctionality open source software ERP dengan studi kasus compiere, openbravo dan xtuple  untuk pengembangan modul pembelajaran ERP	Ultary Hariyaty	2011	SK-931
Analisis solusi mobile customer relationship management untuk meningkatkan penjualan jasa di PT Sucofindo (Persero)	Huda Arta Bahri	2011	SK-937
Analisis students experience terhadap penggunaan twitter sebagai media pemelajaran pada perguruan tinggi	Chita Indah Hayati	2011	SK-904
Analisis tingkat kemetangan e-government direktorat jenderal pendidikan tinggi menggunakan framework deloitte and touche dengan modifikasi penambahan poin infrastruktur dan kebijakan dari framework pemeringkatan e-government indonesia	Muhammad Alfi Nurcahyo	2011	SK-930
Analisis tingkat kesadaran  pengembang terhadap keamanan aplikasi website berdasarkan standar kemanan pengembangan aplikasi	Rinaldi	2011	SK-938
Audit keamanan teknologi informasi (IT) dengan menggunakan kerangka pemetaan ISO/IEC 27002 ke cobit 4.1: studi kasus sekretariat direktorat jenderal pendidikan tinggi (DIKTI)	Eva Zakiah	2011	SK-927
Critical success factor penerapan sistem enterprise resource planning pada perusahaan telekomunikasi di indonesia: studi kasus PT Telekomunikasi  Indonesia, Tbk	Widia Resti Fitriani	2011	SK-907
Critical success factors untuk mempercepat penyebaran mobile commerce: studi kasus Universitas Indonesia	Argiesta Destantria	2011	SK-905
Desain dan implementasi aplikasi matlab client pada android	Chrisma Andhika D.H.	2011	SK-946
Desain dan implementasi aplikasi matlab client pada blackberry	Agus Triutomo	2011	SK-924
Desain dan implementasi aplikasi matlab client pada windows phone 7	Gilang Bhagaskara	2011	SK-972
Desain dan implementasi matlab server berbasiskanservice-oriented architecture	Deddy Hermawan	2011	SK-911
Desain dan implementasi nesdotnet: translator.net framework untuk wireless sensor network berbasis tinyos	Ken Danniswara	2011	SK-956
Desain dan implementasi prototype aplikasi packet analyzer pada wireless sensor network	Ryzky Yudha	2011	SK-976
Desain dan pengembangan tosvs project template dan integrasi nesdotnet (translator.net framework ke nesc) pada visual studio 2010 ultimate 	Dwimasarga Wirasetya	2011	SK-915
Desain rumah cerdas dan implementasinya menggunakan OSGI android	Mohamad Sani	2011	SK-923
Esfindo multi-organisasi versi 2.0	Wais Al Korni	2011	SK-986
Forensik SMS menggunakan statistik deskriptif	Resty Suherlina	2011	SK-942
Identifikasi alat musik tradisional indonesia pada musik monoponik	Ivonne Julietta Siagian	2011	SK-982
Identifikasi critical success factors implementasi e-voting dengan studi kasus penyelenggaraan pemilihan kepala daerah Kabupaten Jembrana	Aprillia Hartami	2011	SK-977
Implementasi abstraktor pada middleware rumah cerdas dengan menggunakan protokol UPNP	Iman Perkasa	2011	SK-940
Implementasi algoritma fuzzy learning vector quantization pada field programmable gate array untuk pendeteksian aritmia	Ruliantyo Syafaadillah Rambe	2011	SK-960
Implementasi algoritma fuzzy learning vector quantization particle swarm  optimization pada FPGA  mendeteksi sleep APNEA	Wahyu Tri Anggoro	2011	SK-958
Implementasi algoritma jaringan saraf tiruan backpropagation pada FPGA dan sistem operasi android untuk mendeteksi sleep APNEA menggunakan fitur data ECG	Muhammad Fajar	2011	SK-968
Implementasi algoritma neural networkfeedforward dalam FPGA	Aji Roland Putra	2011	SK-979
Implementasi business intelligence dengan merancang digital dasboard system untuk  menampilkan informasi dan what-if analysis mengenai inflasi: studi kasus Bank Indonesia	Nugroho Dwi Saputra	2011	SK-932
Implementasi business intelligence pada industri telekomunikasi untuk meningkatkan efektifitas BTS sebagai alat produksi (studi kasus divisi telkom flexi PT telekomunikasi indonesia TBK	Antoni Ridzki Andromeda	2011	SK-947
Implementasi business intelligence studi kasus: perancangan model dashboard untuk mengevaluasi standar pelayanan minimal bidang kesehatan	Inasa Kamila	2011	SK-965
Implementasi dan analisis algprtima aproksimasi untuk pairwise testing dan perbandingannya dengan algoritma brute force	Merryl Frances Nathanie Meka	2011	SK-945
Implementasi klasifikasi mobil pada sistem pengaturan lampu lalu lintas terdistribusi berbasiskan algoritma jaringan syaraf tiruan	Big Zaman	2011	SK-984
Implementasi pemetaan ITIL V3 pada COBIT 4.1 untuk menganalisis kinerja tata kelola IT service operation (service desk function, event management, incident management, dan problem management pada ASEAN IT service delivery PT. Siemens Indonesia	Yulia Fahril	2011	SK-939
Implementasi prototipe sistem pengaturan lampu lalu lintas terdistribusi dengan optimasi pengenalan dan penjejakan kendaraan berbasis pemrosesan video	Faris Al Afif	2011	SK-985
Implementasi wavelet daubechies metode filter bank di FPGA dengan menggunakan bahasa pemrograman VHDL sebagai ekstraksi fitur untuk data ECG arrhythmia	M. Iqbal Tawakal	2011	SK-981
Integrasi RDF store dan reasoning engine dalam prototipe sistem personalisasi e-learning berbasis semantic web	Muhammad Edwin Dwi Putra	2011	SK-898
Metode identifikasi citra dental radiograf pada segmentasi elips secara otomatis	Ade Saputra	2011	SK-806
Model implementasi infrastruktur klien central authentication service untuk keperluan single sign on, studi kasus: Universitas Indonesia	Phillip Leonardo	2011	SK-954
Model implementasi infrastruktur server central authentication server untuk keperluan single sign on : studi kasus Universitas Indonesia	Muhammad Mishbah	2011	SK-941
Modifikasi metode discotope untuk prediksi epitop konformal berbasis anfis	Budianto	2011	SK-899
Pemanfaatan diversity pada sistem perolehan informasi berbahasa indonesia	Antony Raharja W.	2011	SK-1015
Pembangunan model total cost of ownership dengan activity based costing studi kasus pada document management system di ditjen anggaran kementrian keuangan republik indonesia	Luky Kurniawan	2011	SK-906
Pemetaan pelaksanaan tata kelola investasi teknologi informasi dengan menggunakan kerangka  kerja val IT 2.0 di Bank Umum Indonesia: studi kasus Bank XYZ	Larastri Kumaralalita	2011	SK-912
Pemetaan praktik pengamanan teknologi informasi terhadap model digital liability management (dlm) dan analisis faktor kesuksesannya: studi kasus Bank XYZ	Eulis Fitriansyah	2011	SK-921
Pemodelan dan simulasi evolusi perilaku kooperatif pada populasi berstruktur dengan menggunakan graph theory dan evolutionary game theory	Nurul Qomariyah	2011	SK-922
Penerapan agglomerative clustering pada pengembangan lanjut modul pembelajaran tempalte lelucon punning riddle	Try Agustini	2011	SK-963
Penerapan algoritma support vector machine pada time series forecasting harga tiket penerbangan domestik di lima  rute penerbangan di Indonesia	Ari Aditya Nugraha	2011	SK-967
Penerapan konsep social customer relationship management di lingkungan Univeristas Indonesia: studi kasus Fakultas Ilmu Komputer Universitas Indonesia	Malysa Zulsinthya Prihartini	2011	SK-934
Penerapan model component based software engineering untuk impelemntasi visualisasi simulasi keadaan lalu lintas kereta api	Fitri Rachmawati	2011	SK-970
Penerapan steganografi pada musik digital dengan pendekatan transformasi wavelet diskret	I Wayan Wiprayoga Wisesa	2011	SK-916
Penetapan fungsionalitas electronic customer relationship management pada usaha mikro kecil dan menengah toko pakaian: studi kasus mode fashion group	Sri Wahyuni	2011	SK-917
Pengembangan aplikasi indoor environment monitoring berbasis wireless sensor network dan SMS gateway	I Gusti Ngurah Agung Riyandi	2011	SK-914
Pengembangan lanjut agregator berita bahasa indonesia menggunakan teknik content extraction, any-of classifier, dan term counting	Gilang Mentari Hamidy	2011	SK-975
Pengembangan metode lailin untuk segmentasi citra radiografi gigi panoramik	Muhammad Juliandri	2011	SK-902
Pengembangan metode prediksi epitop konformal dengan menggunakan sistem inferensi logika fuzzy	Felicia	2011	SK-900
Pengembangan prototype piranti lunak pada sistem wireless sensor network untuk aplikasi smart farm	Glenn Mohammad	2011	SK-908
Penggunaan buku sekolah elektronik di sekolah dasar: studi kasus SDN Srengseng sawah 15 pagi	Maya Retno Ayu Setyautami	2011	SK-959
Pengujian dan analisa fitur code metrics pada visual studio 2010 untuk aktivitas penjaminan mutu perangkat lunak	Sonya Permata Putri	2011	SK-962
Peningkatan kinerja sistem inferensi kesukuan pada profil DNA manusia menggunakan teori informasi	Erwin Nugraha Bayu Aji	2011	SK-901
Penjaminan mutu sistem informasi bantuan operasioal sekolah melalui pengujian performansi keamanan dan keakuratan	Adi Setiadi	2011	SK-971
Perancangan dan pembangunan perangkat lunak bantu berbasis capability maturity model integration-development (CMMI-DEV) dengan representasi  proses berkelanjutan untuk area proses requirement management (REQM)	Oscar Kurniawan Manule	2011	SK-974
Perancangan enterprise architecture dengan mengunakan the open group architecture framework pada mining industry: studi kasus PT XYZ	Famella Rahma Putri	2011	SK-936
Perancangan solusi enterprise application integration pada organisasi kepemerintahan: studi kasus Direktorat Jenderal Pendidikan Tinggi	Qorib Munajat	2011	SK-926
Perancangan user interface digital  dashboard untuk menyajikan key performances index dan lead indicators: studi  kasus bidang pendidikan dan layanan kemahasiswaan Fakultas Ilmu Komputer Universitas Indonesia	Muhammad Iqbal	2011	SK-973
Perbandingan robustness protokol routing AODV dan DSR pada jaringan pengindra nirkael menggunakan simulator jaringan NS2	Taufiq Jannuar	2011	SK-943
Perolehan informasi iklan dengan menggunakan teknik pengelompokan dan perluasan kueri	Yunita Anggarawati	2011	SK-978
Prototipe knowledge management system berbasis wiki untuk keperluan proyek rekayasa perangkat lunak: studi kasus Pusat Ilmu Komputer Universitas Indonesia	Salman El Farisi	2011	SK-949
Rancangan dan implementasi bahasa simulasi untuk requirement engineering  dalam bentuk animasi behavior tree pada textbe (textual editor for behavior engineering)	Ferdiansyah Dolot	2011	SK-925
Rancangan dan pembuatan sensor kedalaman air tanah	Hary Prabowo Suryoatmojo	2011	SK-1013
Rancangan penerapan audit sistem informasi dengan teknik continuous auditing sebagai sarana evaluasi fungsionalitas sistem informasi berbasis web studi kasus: sistem informasi akademik next generation Universitas Indonesia	Muhammad Fitriansyah	2011	SK-966
Reduksi ukuran popping pada implementasi algortima real-time optimally adapting meshes (Roam) dengan menggunakan perhitungan kesalahan berdasarkan nested world space bounds	Raufan Multahada Safari	2011	SK-929
Rendering secara real-time berbasis ray tracing pada GPU untuk mencapai blurry specularity dengan aplikasi pada interactive furniture viewer	Barziyan	2011	SK-928
Simulasi perluasan jaringan telekomunikasi secara otonom dengan mobile robot di daerah bencana menggunakan open dynamic engine	Abdullah Hafidh	2011	SK-955
Simulation of software requirement in behavior tree using SAL	Niken Listya Pratiwi	2011	SK-969
Sinergi penerapan social customer relationship management untuk meningkatkan interkasi pengguna scele Fakultas Ilmu Komputer Universitas Indonesia	Renny Wijayanti	2011	SK-950
Sistem penjawab soal analogi verbal bahasa indonesia dengan metode latent relational analysis	Novelin Wulan Jayanthi	2011	SK-952
Teori dan implementasi wavelet daubechies metode lifting scheme ke FPGA sebagai ekstraksi fitur sinyal EKG arrhythmia	Fauzi	2011	SK-980
Web site perpustakaan di perguruan tinggi di Indonesia: analisis fitur web 2.0 konten web site	Joseph HJS	2011	SK-???
aktor yang mempengaruhi intensi konsumen untuk berbelanja online studi kasus: Universitas Indonesia	Randita Indrayarto	2011	SK-961
Analisa dan perancangan sistem e-voting pemilihan kepala daerah dalam mendukung penerapan e-government	Freddy Setiawan	2010	SK-855
Analisa pengembangan formalisasi sistem pengendali lalu lintas kereta api	Irene Ully Havsa	2010	SK-874
Analisa situs E-tourism Indonesia: studi terhadap persebaran geografis pengklasifikasian situs serta pemafaatan fungsi dan fitur	Ahmad Murthado	2010	SK-889
Analisis citra CT SCAN organ hati menggunakan sistem fuzzy mamdani	Yuli Biena	2010	SK-849
Analisis dampak intangible dari implementasi SAP di perusahaan multinasional studi kasus  PT XYZ	Dephira Amenike	2010	SK-824
Analisis dan pemodelan sistem knowledge management untuk e-government yang mendukung hubungan government to employee (G2E)	Mubarik Ahmad	2010	SK-857
Analisis dukungan teknologi informasi terhadap penerapan inisiatif knowledge management: studi kasus PT FIF	Genta Moerita	2010	SK-821
Analisis kepuasan pengunaan scele pada mahasiswa Fakultas Ilmu Komputer Universitas Indonesia  dengan menggunakan pendekatan negative critical incidents	Meldi Harrosyid	2010	SK-818
Analisis kinerja algoritma pemberian tanda air pada video digital dengan memanfaatkan batas kontras dimensi temporal	Nadissa C.	2010	SK-837
Analisis kinerja aplikasi gromacs pada GPU dan pada lingkungan komputasi cluster	Ari Wibisono	2010	SK-859
Analisis kinerja cluster hastinapura menggunakan dinamika molekular RAD GTpase dengan aplikasi AMBER	Toni Dermawan Yuliyanto	2010	SK-877
Analisis pengimplementasian robot Al Fath menggunakan algoritma modifikasi partikel SWARM optimization dalam pencarian multi sumber asap	Achmad Rohman	2010	SK-815
Analisis perbandingan performa metode ekstraksi fitur citra pada studi kasus pengenalan aliran realisme dan abstraksionisme citra lukisan indonesia	Tieta Antaresti RP	2010	SK-832
Analisis pola adopsi teknologi WI-FI berdasarkan mobile phone technology adoption model (Moptam) dengan pendekatan structural equation modeling (SEM)	Fani Jasmine Bahar	2010	SK-817
Analisis proses pengujian perangkat lunak menggunakan software testing maturity model	Risnal Diansyah	2010	SK-814
Analisis spasial dengan metode density-based spa-tial clustering of application with noise pada basis data kriminal	Phina Lidyawati	2010	SK-842
Analisis temporal dengan metode clustering interactive K-means pada basis data kriminal	Ivonne Margi Immanuella	2010	SK-845
Aplikasi L7-filter untuk firewall netfilter/IPtables	Jonathan A.P. Marpaung	2010	SK-863
Counting the silent identifikasi partisipasi publik dan non publik dalam komunitas online: studi kasus scele Fasilkom Univeristas Indonesia	Wahnan Ahmal A.	2010	SK-888
Declarative animation system using functional arrows	Laverdy Pramula	2010	SK-807
Desain alat bantu untuk membuat konten aplikasi middleware berbasis MHP pada sistem siaran televisi digital	Faruk Candra Farari	2010	SK-861
Desain dan implementasi algoritma paralel pada konversi BIT rate video dan audio pada berkas multimedia MPEG-4 menggunakan API library LIBAV dan MPI	Achmad Hafid	2010	SK-895
Desain dan implementasi aplikasi middleware berbasis windows HPC server untuk komputasi paralel pada excel	Sagi Arsyad	2010	SK-880
Desain dan implementasi aplikasi simulator wireless sensor network	A.C. Arsyady	2010	SK-894
Desain dan implementasi engine simulasi pengendalian lampu lalu lintas secara terdistribusi menggunakan model kuramoto	Hendra Marihot	2010	SK-858
Desain dan implementasi library untuk aplikasi social network analyzer studi kasus : facebook	Ramadhan Kurniawan Sagala	2010	SK-892
Desain dan implementasi portal basisdata tanaman obat Indonesia sebagai penerapan knowledge management	Marjuki Rahmat	2010	SK-988
Desain pengembangan sistem playout management content (PMC) untuk program siaran televisi digital berbasiskan opencaster pada arsitektur clent-server	Gregorio Gringo Honassan	2010	SK-856
Diagnosis ginjal untuk identifikasi kanker ovarium menggunakan metodologi fuzzy	Achmad Hariyadi	2010	SK-833
Diagnosis uterus berbasis citra CT scan menggunakan pendekatan fuzzy	Priska Kalista	2010	SK-872
Eksplorasi formalisasi TLA+dalam theorem prover Hol	Iis Solichah	2010	SK-875
Evaluasi kinerja autodock 4.2 dan autodock vina 1.1 dalam proses molecilar docking dan virtual screening di lingkungan cluster hastinapura	Muhammad H. Hilman	2010	SK-864
Evaluasi teknik perolehan informasi pada dokumen web iklan	Rifqi Fuadi	2010	SK-882
Identifikasi model knowledge sharing dalam jaringan informal menggunakan social network analysis: studi kasus bagian perencanaan dan strategi divisi teknologi informasi Bank X	Diandra Aditya Kusumawardhani	2010	SK-808
Identifikasi pola knowledge sharing pada situs jejaring sosial menggunakan teknik analisis jarimgan sosial: studi kasus grup X pada situs facebook	Dian Seprina	2010	SK-887
Image enhancement dan image restoration pada citra dokumen tua menggunakan genetic algorithm	Hilda Deborah	2010	SK-838
Implementasi algoritma adaptive random testing dengan pendekatan berorientasi objek dan perbandingannya dengan basic random testing	Reffynda Esna Putri	2010	SK-840
Implementasi algoritma klasifikasi C4.5 sebagai bagian dari data mining algorithm collection	Mesa Rahmi	2010	SK-836
Implementasi algoritma prefixspan sebagai bagian dari data mining algorithm collecion	Latifah	2010	SK-835
Implementasi ekstraksi sitasi mengacu pada aturan format apa dan MLA pada bibliografi karya ilmiah di perpustakaan dijital Universitas Indonesia	Hazlinda Aziz	2010	SK-843
Implementasi multi-organisasi pada sistem pengelolaan pembelajaran: studi kasus esfindo	Baginda Anggun Nan Cenka	2010	SK-844
Implementasi pendeteksian dan penghitungan mobil dengan pemrosesan video untuk sistem pengendalian lampu lalu lintas terdistribusi	Manggala Eka Adideswar	2010	SK-867
Implementasi personalisasi pembelajaran berdasarkan gaya belajar introvert dan ekstrovert pada student centered e-learning environment (SCELE) Fakultas Ilmu Komputer Universitas Indonesia	Deswati	2010	SK-841
Implementasi protokol JXTA pada aplikasi L7-filter	Bhimo Bhaskoro	2010	SK-890
Implementasi repository keterhubungan materi dengan mata kuliah pada student centered e-learning environment (scele) Fakultas Ilmu Komputer Universitas Indonesia	Winda Sagita	2010	SK-862
Integrasi windows  HPC server 2008 R2 dan linux grid menggunakan BES++	Hisma Mulya Sudrajat	2010	SK-896
Manajemen sistem berkas berbasis gridFTP di lingkungan GRID	Nico Anandito	2010	SK-831
Membangun hubungan antara organisasi dengan para pemangku kepentingannya: studi kasus pada organisasi nirlaba di Indonesia dengan menggunakan situs jejaring sosial facebook	Laras Anggun Bestari	2010	SK-816
Modifikasi dan pengembangan sistem deteksi asap berbasis video	Lutfi Ardiansyah	2010	SK-881
Modul query dan penyimpanan ontologi pada sistem personalisasi e-learning berbasis semantic web	Dimas Rahmanto	2010	SK-852
OWLIZR: Sistem representasi pengetahuan teks bahasa indonesia berbasis web ontology language description logic (OWL DL)	Fariz Darari	2010	SK-834
Pembentukan formasi pola robot homogen secara gradual: studi kasus pada robot lLego Mindstorms NXT	Nulad Wisnu Pambudi	2010	SK-810
Pembuatan OR code berdekorasi serta implementasi OR code encoder dengan menggunakan java	Hendri	2010	SK-873
Penentuan critical success factors pada website internet banking ditinjau dari aspek kebutuhan pengguna sebagai nasabah individual dengan studi kasus BCA, Bank Mandiri dan BNI	Irvan Ferdiansyah	2010	SK-891
Penentuan rekomendasi tajuk subyek pada koleksi metadata dokumen perpustakaan Universitas Indonesia dengan algortima cosine similarity dan jaccard similarity	Evi Yulianti	2010	SK-846
Penerapan metode klasifikasi musik tradisional indonesia untuk perolehan informasi musik polifonik	Hendy Kusumo Nugroho	2010	SK-884
Penerapan model component based software engineering untuk implementasi visualisasi simulasi keadaan lalu lintas	Michael Wicaksana Putra	2010	SK-865
Penerjemahan transitif menggunakan mesin penerjemah statistik untuk bahasa indonesia dan bahasa jerman	Rosalina	2010	SK-878
Pengaruh alur cerita, grafis, suara, kontrol, lama permainan, tingkat kesulitan, dan pengaturan tampilan antarmuka terhadap tingkat enjoyment dan intention dalam memainkan permaninan online	Sactio Swastioyono	2010	SK-853
Pengaruh relevance, accuracy, timeliness, comprehensiveness, format, reliability, understandability, source expertise dan source trustworthines dari electronic word of mouth terhadap tingkatan information usefulness dan tingkatan information adoption dalam komunitas online kaskus	Maleo Angga Dewantoro	2010	SK-876
Pengembangan aplikasi penerjemahan QR code berbasis J2ME (Java 2 micro edition) pada ponsel berkamera dengan menerapkan error control coding	Lucky Haryadi	2010	SK-854
Pengembangan e-training berbasis pembelajaran kontekstual: studi kasus pusat pendidikan dan pelatihan badan pusat statistik indonesia	Nafisah	2010	SK-870
Pengembangan metode pencarian kedekatan antar vektor fuzzy pada sistem penentuan sudut citra wajah tiga dimensi	R. Brahmastro Kresnaraman	2010	SK-839
Pengembangan modul perilaku pada sistem lokalisasi sumber asap dengan menggunakan algoritma particle swarm optimization dan algoritma zig-zag	Ferdian Jovan	2010	SK-869
Pengembangan sistem agregator berita bahasa indonesia dengan klasifikasi berbasis naive bayes dan clustering berbasis non-negative matrix factorization	Natasha	2010	SK-827
Pengembangan sistem analisis semantik bahasa indonesia berdasarkan sistem controlled english to logic translation (CELT) dan penerapannya pada sistem tanya jawab yang menggunakan suggested upper merged ontology (SUMO)	Angga Kho Meidy	2010	SK-828
Pengembangan sistem jaringan surat dinas berbasis XML	Emny Harna Yossy	2010	SK-850
Pengembangan sistem pencari pakar dengan menggunakan metode association rules	Moehammad Arief Furqon	2010	SK-860
Pengembangan sistem pengenal suara biligual untuk bahasa indonesia dan inggris menggunakan satu model akustik	Ronny	2010	SK-819
Pengembangan sistem pengenalan suara untuk bahasa indonesia yang mempunyai aksen	Indah Chandra	2010	SK-879
Pengembangan web service berbasis soap dan rest untuk informasi leksikal bahasa indoensia pada proyek language grid	Ishak Sianturi	2010	SK-829
Pengenalan dan pencarian posisi absolut robot dengan menggunakan banyak kamera studi kasus: pencarian sumber kebocoran gas	Dhiemas RYS	2010	SK-868
Penggunaan teknik urutan kata dalam sistem penilaian esai otomatis untuk bahasa indonesia dengan metode latent semantic analysis	Randy Oktavianus Halim	2010	SK-871
Penggunaan teknologi stereoscopy untuk visualisasi data	Abe Mitsuteru	2010	SK-897
Perancangan digital dashboard system untuk menyajikan sensitivity analysis kinerja keuangan perusahaan: studi kasus PT XYZ	William Suhaidir	2010	SK-825
Perancangan solusi integrasi sistem informasi dengan menggunakan pendekatan enterprise application integration (EAI) pada perusahaan ritel dengan studi kasus PT GAM	Tina Purbawati	2010	SK-847
Perbandingan clustering citra menggunakan kombinasi fitur warna, tekstur dan bentuk	Purwanto	2010	SK-885
Peringkas otomatis forum student centered e-learning environment (Scele) Fakultas Ilmu Komputer Universitas Indonesia menggunakan metode centroid, first sentence overlap dan persamaan judul	Fatimah	2010	SK-848
Proses reasoning dan pembuatan aturan semantik pada sistem personalisasi e-learning berbasis semantic web	Yuan Hanif Syaniardi	2010	SK-851
Pustaka akses berkas dan aplikasi konsol pengguna untuk sistem berkas berbasis gridftp di lingkungan grid	Ridho Budiharto	2010	SK-830
Rancangan kompilator bahasa lingu dengan native code generator melalui low level virtual machine (LLVM)	Mario Ray Mahardhika	2010	SK-893
Studi banding metode clustering pada analisis citra biomedis dan remote sensing dengan fuzzy C-Means, dan optimized K-Means	Lucia Roly Prihandini	2010	SK-804
Studi banding metode perolehan gambar untuk mendapatkan keanekaragaman hasil pencarian	Bilih Priyogi	2010	SK-883
Tingkat implementasi e-government pada level kementrian di Indonesia berdasarkan framework deloitte & Touche	Nurulita Prihasti Kardia	2010	SK-826
Usulan pengembangan model matematika pengaturan lampu lalu lintas simpang-n secara terdistribusi berbasiskan nonlinear coupled oscillator dan sinkronisasi kuramoto	Syarief Abdurrahman	2010	SK-866
Analisis adopsi teknologi komputer dengan pendekatan structural equation modeling: studi empiris pada asisten dosen Universitas Indonesia/ Asa Ramdhani	Asa Ramdhani	2009	SK-792
Analisis dan perancangan strategi pada pertnadingan sepak bola antar robot	Candra Adhi Wibawa	2009	SK-762
Analisis perbandingan antara metode sparse representation dengan eigenface dalam sistem pengenalan wajah	Farania Gama Ardhina Rangkuti	2009	SK-751
Analisis perbedaan potential, new, dan experienced e-customers serta kaitanya terhadap perilaku online purchasing: studi empiris pada e-customers di kalangan civitas academica Universitas Indonesia	Ishara Yusdian Arief	2009	SK-802
Aplikasi operasi-operasi fuzzy union dan intersection pada fuzzy interpreter sistem basis data fuzzy/ Chandra Prasetyo Utomo	Chandra Prasetyo Utomo	2009	SK-793
Blankon: sebuah studi kasus pengembangan perangkat lunak bebas/ Dominikus Randy	Dominikus Randy	2009	SK-774
Desain dan simulasi indonesia education grid dengan gridsim toolkit	Ivo Bahar Nugroho	2009	SK-803
Eksperimen formalisasi dalam sistem hol dengan studi kasus teori graph/ Ricky Suryadharma	Ricky Suryadharma	2009	SK-779
Implementasi personalisasi pembelajaran berdasarkan pengetahuan awal dengan menggunakan SCORM	Roma Romansyah	2009	SK-820
Implementasi protokol oblivious transfer untuk pemilihan berkas dalam lingkungan klien server	Obeth Mangara Simatupang	2009	SK-0617
Kajian unjuk kerja GPGPU (General-purpose computation on graphics processing Units)	Riza Guntur Prakoso	2009	SK-822
Multi-camera tracking untuk robot soccer	Andre Tampubolon	2009	SK-813
Pemanfaatan dokumen unlabeled pada klasifikasi topik berbasis naive bayes dengan algoritma expectation maximization/ Bayu Distiawan Trisedya	Bayu Distiawan Trisedya	2009	SK-776
Pemetaan citra long rang CCTV pada citra digital menggunakan teori pengukuran fuzzy sugeno trigonometri	Haryadi Herdian	2009	SK-755
Penanganan jaringan komunikasi multihop terkonfigurasi sendiri pada kasus dua atau banyak sumber dengan menggunakan koloni robot otonom terdistribusi berdasarkan prinsip kecerdasan kolektif serta pengembangan simulator NAML	Rizki Mardian	2009	SK-750
Pencarian Pola Sekuensial Menggunakan Algoritma  Apriori All	Fandi	2009	SK-765
Pendefinisian instrumen evaluasi website e-commerce business to consumer	Suci Lestari Nurhayati	2009	SK-811
Penentuan sudut pandang citra wajah 3D terdistorsi menggunakan interpolasi vektor dengan rata-rata dan fuzzy pada setiap dimensi/ muchamad Irvan G.	Muchamad Irvan G.	2009	SK-788
Penerapan metode pohon keputusan dengan algoritma C4.5 pada sistem penunjang keputusan dalam memprakirakan cuaca jangka pendek	Novi Indriyani	2009	SK-756
Penerapan ontologi objek pembelajaran untuk kebutuhan personalisasi E-learning berbasis semantic web/ Meirna Asti Ramadhanie	Meirna Asti Ramadhanie	2009	SK-794
Penerapan relasi fuzzy untuk ekspansi kata kunci pada mesin pencari dan pemeringkatan hasil dengan sistem inferensi fuzzy/ Ginanjar Cahya Komara	Ginanjar Cahya Komara	2009	SK-753
Penerjemahan dokumen inggris-indonesia menggunakan mesin penerjemah statistik dengan word reordering dan phrase reordering	Hansel Tanuwijaya	2009	SK-763
Penerjemahan suara ke suara dari bahasa Indonesia ke bahasa Inggris/ Darwin Cuputra	Darwin Cuputra	2009	SK-787
Penerjemahan teks Indonesia-Inggris otomatis menggunakan mesin penerjemah statistik berdasarkan frase dengan koleksi dokumen menggunakan part-of-speech tagging dan lema	Metti Zakaria W.	2009	SK-768
Penerjemahan teks indonesia-jepang otomatis menggunakan mesin penerjema statistik berdasarkan frase/ Bernadia Puspasari	Bernadia Puspasari	2009	SK-786
Pengelolaan bencana: identifikasi wilayah bencana dan deteksi kerusakan tekhnik registrasi citra satelit sebelum dan sesudah bencana menggunakan mutual  informasi besarnya kerusakan dengan teknik registrasi citra satelit sebelum dan sesudah bencana menggunakan mutual information dan sistem inferensi fuzzy	Sri Krisna  Karunia	2009	SK-767
Pengelolaan bencana: identifikasi wilayah bencana dengan menggunakan sistem informasi geografis dan inferensi fuzzy	Antonius Hendra Waskita	2009	SK-805
Pengelompokan dokumen bahasa indonesia dengan teknik reduksi dimensi nonnegative matrix factorization dan random projection	Suryanto Ang	2009	SK-752
Pengembangan algoritma pembelajaran berbasiskan dimensi serta komparasinya terhadap pembelajaran berbasiskan vektor pada fuzzy-neuro learning vector quantization untuk pengenalan citra wajah frontal/ Laksmita Rahadianti	Laksmita Rahadianti	2009	SK-781
Pengembangan aturan-aturan sintaksis bahasa indonesia menggunakan lexical functional grammar untuk kalimat deklaratif sederhana	Arawinda Dinakaramani	2009	SK-745
Pengembangan model knowledge management system pada lembaga riset: studi kasus badan pengkajian dan penerapan teknologi (BPPT)	Pita Larasati Fauziah Nur	2009	SK-760
Pengembangan model phonetic similarity bahasa indonesia berdasarkan kamus fonetik bahasa indonesia zahra	Dwi Putra Handi Pareh	2009	SK-748
Pengembangan pengurai morfologi untuk bahasa indonesia formal dan gaul berbasis morfologi dua tingkat dengan menggunakan XFST dan LEXC	Pomona Angela KM	2009	SK-809
Pengembangan simulasi pengaturan lampu lalu lintas secara terdistribusi dengan menggunakan open dynamics engine	Adhitya Novian Raidy	2009	SK-759
Pengembangan sistem ekstraksi informasi untuk dokumen legal indonesia dengan studi kasus dokumen peraturan pemerintah republik indonesia/ Mulyandra Pratama	Mulyandra Pratama	2009	SK-796
Pengembangan sistem ekstraksi informasi untuk dokumen legal indonesia: studi kasus dokumen undang-undang Republik Indonesia	Susy Violina	2009	SK-747
Pengembangan sistem informasi rekapitulasi dokumen perundang-undangan di indonesia/ Rizal Mulyadi	Rizal Mulyadi	2009	SK-783
Pengembangan sistem natural language generation dengan pendekatan chart generation serta penerapannya pada sistem tanya jawab indonesia/ Rangga M. Jati	Rangga M. Jati	2009	SK-742
Pengembangan sistem pembelajaran kolaboratif online berbasis knowldge construction/ Puspa Setia Pratiwi	Puspa Setia Pratiwi	2009	SK-775
Pengembangan sistem perolehan informasi untuk dokumen legal indonesia/ Yans Sukma Pratama	Yans Sukma Pratama	2009	SK-773
Pengembangan sistem real time auto door-lock dengan menggunakan algoritma fuzzy neuro learning vector quatization berbasiskan dimensi/ Anugrah Ramadhani	Anugrah Ramadhani	2009	SK-782
Pengembangan student model ontology untuk personalisasi pembelajaran  online berbasis semantic web	Leonny Pramitasari	2009	SK-799
Pengembangan web service pengurai morfologi bahasa indonesia pada language grid	Charles Christian	2009	SK-746
Pengenalan bentuk gigi pada citra dental radiograph dengan bantuan sistem inferensi fuzzy mamdani/ Hanif Rasyidi	Hanif Rasyidi	2009	SK-791
Pengenalan citra wajah 3D terdegradasi menggunakan hemispheric structure of hidden layer neural network/ Hari Prasetyo	Hari Prasetyo	2009	SK-780
Pengenalan iris menggunakan pattern matching dan jaringan syaraf tiruan/ Danu Widatama	Danu Widatama	2009	SK-789
Pengenalan wajah 3D menggunakan hemispheric structure of hidden layer dengan pemanfaatan interpolasi spline sebagai pengenal sudut wajah	Rivki Hendriyan	2009	SK-744
Penggunaan gambar wajah pada situs business-to-consumer e-commerce sebagai strategi untuk meningkatkan kepercayaan (TRUST) pelanggan	Berliyanto	2009	SK-801
Pengklasifikasian artikel berita berbahasa indonesia secara otomatis menggunakan ontologi/ Prajna Wira Basnur	Prajna Wira Basnur	2009	SK-790
Pengujian perangkat lunak terotomatisasi dengan menggunakan rational robot dan rational testmanager studi kasus aplikasi E-paspor/ Rina Violyta	Rina Violyta	2009	SK-770
Penyajian objek pembelajaran berbasis scorm secara non-sequencing dan linear sequencing studi kasus: Fakultas Ilmu Komputer Universitas Indonesia	Yasna Suwita	2009	SK-812
Penyelesaian penjadwalan kuliah sebagai constraint satisfaction problem dengan genetic algorithm/ Teddy	Teddy	2009	SK-766
Perancangan konfigurasi permainan scrabble untuk bahasa indonesia berdasarkan distribusi huruf kamus besar bahasa indonesia/ Arudea Mahartianto	Arudea  Mahartianto	2009	SK-741
Perancangan ontologi learning performance untuk sistem personalisasi e-learning berbasis semantic web	Yohanes Immanuel	2009	SK-798
Perangkat Lunak Pencocokan citra dental X-RAY dengan Zernike moment untuk identifikasi korban bencana	Muhammad Haris	2009	SK-754
Perbandingan beberapa metode image clustering berdasarkan komposisi warna	Elisabeth Martha Koeanan	2009	SK-761
Perbandingan kinerja zigbee dan bluetoth untuk wireless personal area network/ Imairi Eitiveni	Imairi Eitiveni	2009	SK-777
Perbandingan metode latent semantic analysis dan vector space model untuk sistem penilai jawaban esai otomatis  bahasa indonesia/ Heninggar Septiantri	Heninggar Septiantri	2009	SK-785
Perolehan Opini pada Dokumen Blog Berbahasa Indonesia/ Clara Vania	Clara Vania	2009	SK-771
Perolehan gambar menggunakan koleksi kain tradisional indonesia/ Sugianto Angkasa	Sugianto Angkasa	2009	SK-778
Perolehan informasi dokumen suara pembicaraan berdasarkan hasil dari sistem pengenalan suara untuk bahasa indonesia/ Armando Yonathan	Armando Yonathan	2009	SK-784
Segmentasi citra sel positif pulasan imunohistokimia pada kanker payudara menggunakan fuzzy morphologi	Bobby Alexander Wiwaha	2009	SK-757
Segmentasi dokumen bahasa indonesia menggunakan metode genetic algorithm/ Vinky Halim	Vinky Halim	2009	SK-764
Simulasi dan analisis particle swarm optimization untuk pencarian banyak sumber gas dengan open dynamics engine	Ranu Wijoyo	2009	SK-769
Spesifikasi dan verifikasi aplikasi perbankan dengan menggunakan lingusql (Studi banding dengan Metode-B)/ Franova Herdiyanto	Franova Hardiyanto	2009	SK-743
Studi banding deteksi objek sel PAP Smear dengan metode hough transform dan genetic algorithms	Anita Kosasih	2009	SK-800
Studi komparasi penerapan logika fuzzy pada uji kemiripan profil DNA manusia	Lia Sadita	2009	SK-758
Studi pengukuran kemiripan rantai DNA virus H5N1 berbasis himpunan fuzzy/ Ikhlas Purwanto	Ikhlas Purwanto	2009	SK-772
Verifikasi sistem pengendali lalu lintas kereta api dengan model checker NUSMV/ Annisa Ihsani	Annisa Ihsani	2009	SK-795
A Cultural perspective of m-commerce adoption in indonesian: case study university of Indonesia/ Pandu Adilaras	Pandu Adilaras	2008	SK-0709
Analisis kamus fonetik model bahasa, dan konfigurasi properti pada sistem pengenal suara untuk bahasa indonesia menggunakan sphinx-4/ Sadar Baskoro S. 	Sadar Baskoro S	2008	SK-723
Analisis pola adopsi teknologi 3G pada kalangan mahasiswa Universitas Indonesia berdasarkan model sarker dan wells dengan menggunakan teknik structural equation modeling/ Alida Widianti	Alida Widianti	2008	SK-0711
Analisis sentimen menggunakan metode naive bayes, maximum entropy, dan support vector machine pada dokumen berbahsa inggris dan dokumen berbahasa indonesia hasil penerjemah otomatis/ Franky	Franky	2008	SK-0705
Assessing the performance and impact of knowledge management system on particular organisational process: a  study case in BANK X/ Riza Harmonika	Riza Harmonika	2008	SK-0708
Automatic english to indonesian lexical mapping using latent semantic analysis/ Eliza Margaretha	Eliza  Margaretha	2008	SK-0713
Deteksi Paranodus pada citra jaringan saraf gigi manusia/ M. Rabindra Surya	M. Rabindra Surya	2008	SK-724
Evaluasi teknik pengindeksan untuk perolehan informasi pembicaraan/ Sutatnto Sugii Joji	Sutanto Sugii Joji	2008	SK-734
Evaluasi teknik perolehan informasi pada dokumen web multibahasa/ Ananda Budi Prasetya	Ananda Budi Prasetya	2008	SK-726
Faktor-faktor sistem interaksi yang mempengaruhi efektivitas iklan online pada populasi civitas akademika Universitas Indonesia/ Ilham Aji Pratomo	Ilham Aji Pratomo	2008	SK-0720
Implementasi algoritma clustering (Cobweb dan iterate) sebagai bagian dari data mining algorithms collection	Adolf Pandapotan	2008	SK-0716
Implementasi algoritma principal type dan algoritma type inhabitant dari type theory TA-Lambda menggunakan definite clause grammar dalam PROLOG	Ario Santoso	2008	SK-0719
Implementasi dan analisis terhadap verifikasi perangkat lunak berbasis java dengan T2 framework dengan studi kasus electronic votes manager sebagai perangkat lunak berbasis komponen/ Aziz Yudi Prasetyo	Aziz Yudi Prasetya	2008	SK-0721
Kajian penelitian sistem informasi/teknologi informasi di Indonesia/ Aziiz Surahman	Aziiz Surahman	2008	SK-0700
Klasifikasi topik menggunakan metode naive bayes dan maximum entropy pada artikel media massa dan abstrak tulisan ilmiah/ Dyta Anggraeni	Dyta Anggraeni	2008	SK-739
Modifikasi particle swarm optimization untuk pencarian banyak sumber asap dengan visualisasi/ Aditya Nugraha	Aditya Nugraha	2008	SK-0715
Pencocokan dental X-Ray image dengan fuzzy similarity dan least square loss function/ Muhammad Azani Hasibuan	Muhammad Azani Hasibuan	2008	SK-0730
Pendeteksian natrium tipe Nav1.8 pada citra jaringan saraf gigi manusia/ Mellawaty	Mellawaty	2008	SK-727
Penentuan sudut pandang wajah 3 dimensi dengan menggunakan interpolasi spline dan interpolasi linier sebagai fungsi pembentuk garis ciri/ Hadaiq Rolis Sanabila	Hadaiq Rolis Sanabila	2008	SK-0712
Penerapan analytic hierarchy process dalam sistem penunjang keputusan pemilihan obat (SIPEBAT)/ Fahrurrozi	Fahrurrozi	2008	SK-0717
Penerapan what-if analysis pada sistem penunjang keputusan dalam menentukan porsi makanan/ Vidyanita Kumalasari	Vidyanita Kumalasari	2008	SK-0702
Pengembangan lanjut analisis semantik bahasa indonesia serta penerapannya dalam sistem tanya jawab dengan menggunakan kombinasi pendekatan syntax-driven semantic analysis NLP Axiom, dan world knowledge axiom/ Rahmad Mahendra	Rahmad Mahendra	2008	SK-???
Pengembangan lanjut pengurai morfologi untuk bahasa indonesia berbasiskan morfologi dua tingkat menggunakan XFST dan LEXC/ Femphy Pisceldo	Femphy Pisceldo	2008	SK-0710
Pengembangan part of speech tagger untuk bahasa indonesia berdasarkan metode conditional random fields dan transformation based learning/ Triastuti Chandrawati	Triastuti Chandrawati	2008	SK-736
Pengembangan prototipe semantic portal berbasis ontologi komunitas riset: studi kasus fakultas ilmu komputer Universitas Indonesia/ Yemima Aprilia	Yemima Aprillia	2008	SK-0706
Pengembangan versi awal wordnet bahasa indonesia dengan pendekatan expand menggunakan aplikasi web-based  dan analisis statistik KAPPA/ Desmond Darma Putra	Desmond Darma Putra	2008	SK-0707
Penggunaan pengelompokan dokumen untuk mengurangi ambiguitas kata pada perolehan informasi lintas bahasa/ Rama Rizki	Rama Rizki	2008	SK-735
Pengindeksan berdasarkan lokasi pada perolehan informasi geografis/ Moh Ibrahim	Moh Ibrahim	2008	SK-???
Pengujian perangkat lunak dengan software rational testmanager dan rational robot/ Agung Widiyarto	Agung Widiyarto	2008	SK-740
Penyusunan kamus fonetik dalam pengembangan sistem pengenalan suara otomatis untuk bahasa indonesia/ Amalia Zahra	Amalia Zahra	2008	SK-0722
Perbandingan eigenface dan klustering K-means dengan koreksi GAMMA untuk mengukur similaritas alis pada sistem identifikasi buron/ M. Faisal Reza	M. Faisal Reza	2008	SK-728
Peringkas multi-dokumen untuk bahasa indonesia menggunakan teknik cetroid-based summarization dan teknik k-means-based summarization/ Wisnu L. Wardhana	Wisnu L.Wardhana	2008	SK-733
Perolehan informasi lintas bahasa inggris-indonesia berdasarkan korpus yang sebanding menggunakan telnik phi square dan koefisien korelasi pearson/ Aprilia	Aprilia	2008	SK-729
Perolehan informasi musik poliponik berdasarkan isi untuk lagu daerah indonesia/ Aurora Marsye	Aurora Marsye	2008	SK-731
Prototipe sistem pengawasan pergerakan sederhana manusia menggunakan sistem inferensi fuzzy/ Muhammad Mulki Armansyah	Muhammad Mulki Armansyah	2008	SK-0704
Sistem pengaturan lalu lintas terdistribusi dengan menggunakan nonlinear coupled oscillator/ Abdul Arfan	Abdul Arfan	2008	SK-0714
Sistem pengenalan wajah menggunakan metode voting berbasis eigenface dan jarak euclidean/ Verra Mukty	Verra Mukty	2008	SK-0718
Sistem penghitung pengunjung menggunakan teori pengukuran fuzzy/ Martin Leonard Tangel	Martin Leonard Tangel	2008	SK-0703
Sistem penghitung pengunjung secara vertikal menggunakan HAAR-LIKE Features dan Boosting/ Ikhsan Putra Kurniawan	Ikhsan Putra Kurniawan	2008	SK-738
Algoritma restorasi warna dalam keadaan minim pencahayaan dengan logika fuzzy dan jaringan saraf tiruan/ Budi Irawan	Budi Irawan	2007	SK-0680
Analisa isi electronic journal on information system in developing countries (EJISDC)	Jaka N Indrawan	2007	SK-0653
Analisis kuantitatif penerapan metodologi pengembangan  perangkat lunak di Indonesia/ Yanuar Widjaja	Yanuar Widjaja	2007	SK-0670
Analisis pendukung teknologi informasi terhadap inisiatif knowledge management: studi kasus PT. Bank XYZ, Tbk/ Lusiana Darmawan	Lusiana Darmawan	2007	SK-0674
Analisis penerapan software quality assurance (SQA), Studi kasus: Indonesia	Yudi Ariawan	2007	SK-0684
Efek penerapan pemotongan imbuhan kata, operator kedekatan kata, struktur dokumen web, serta umpan balik relevan semu terhadap kinerja perolehan informasi web/ Okky Hendriansyah Tri Firgantoro	Okky Hendriansyah Tri Firgantoro	2007	SK-0675
Ekstraksi dan kemiripan fitur mata pada sistem identifikasi buron/ Daniel Cahyadi	Daniel Cahyadi	2007	SK-0691
Ekstraksi titik fitur wajah menggunakan partial least square regession/ Muhammad Hasrul Ma'ruf	Muhammad Hasrul Ma'ruf	2007	SK-0666
Ektraksi fitur wajah dengan metode gabor wavelet/ Arie Murdianto	Arie Murdianto	2007	SK-0686
Estimasi level dekomposisi optimal untuk fusi citra multisensor multiresolusi berbasis web/ Amir Muhammad	Amir Muhammad	2007	SK-0673
Identifikasi lokasi dan perluasan query pada sistem perolehan informasi geografis/ Nasikin	Nasikhin	2007	SK-0669
Implementasi algoritma klasifikasi CMAR sebagai bagian dari data mining algorithm collection/ Ranni Kusumawardhani	Ranni Kusumawardhani	2007	SK-0671
Implementasi genetic algorithm dan A* untuk menyelesaikan unique navigation objective pada project Hoshimi 2007/ Anwar Chandra	Anwar Chandra	2007	SK-0688
Kajian penelitian tugas akhir mahasiswa strata 1 yang berhubungan dengan sistem informasi di lingkungan Universitas Indonesia/ Deborah Y.N.N.	Deborah Y.N.	2007	SK-0677
Kajian tugas akhir strata 1 dilingkungan Fakultas Ilmu Komputer Universitas Indonesia	Shinta T. Effendy	2007	SK-0651
Kesesuaian aplikasi CRM terhadap proses bisnis CRM pada UKM toko buku berdasarkan framework based on thoery of CRM/ Wira Perdana	Wira Perdana	2007	SK-0687
Klasifikasi email berbahasa Indonesia menggunakan jaringan syaraf tiruan dengan algoritma pembelajaran propagasi-balik/ Hario Adit Wibisono	Hario Adit Wibisono	2007	SK-0659
Metode pengukuran desain berorientasi objek berbasis metrics object oriented design (MOOD)/ Nurmaya	Nurmaya	2007	SK-0668
Modifikasi algoritma grover untuk pencarian kunci enkripsi dengan komputer kuantum/ Syalim Amril	Fahrurrozi Rahman	2007	SK-0672
Partitinal clustering (K-means, nearest neighbour, dan fuzzy c-means) sebagai bagian dari data mining algorithms colleciton/ Anthony Steven	Anthony Steven	2007	SK-0679
Pemanfaatan globus monitoring and discovery system untuk membangun layanan informasi dalam lingkungan komputasi ingrid/ Fajar Muharandy	Fajar Muharandy	2007	SK-0663
Pencarian string dengan menggunakan metode indexing pada data genomic/ Desiana Nurul Maftuhah	Desiana Nurul Maftuhah	2007	SK-0661
Penemuan jawaban pada sistem tanya jawab bahasa Indonesia-Inggris dengan pembobotan kata dan informasi dari internet/ Septian Adiwibowo	Septian Adiwibowo	2007	SK-699
Penerapan logika UNITY dalam sertifikasi perangkat lunak berbasis komponen dengan studi kasus aplikasi E-Voting/ Prastudy Mungkas Fauzi	Prastudy Mungkas Fauzi	2007	SK-0690
Penerapan metode analytic hierarchy process dalam sistem penunjang keputusan untuk pemilihan asuransi	Fitria Rahma Sari	2007	SK-0650
Pengembangan awal analisis semantik bahasa Indonesia dengan metode syntax-driven semantic analysis dan penerapannya dalam sistem tanya jawab/ Septina Dian Larasati	Septina Dian Larasati	2007	SK-0657
Pengembangan portlet kompilator dan portlet aplikasi untuk portal grid dalam infrastruktur indonesia grid/ Suryamita Harindrari	Suryamita Harindrari	2007	SK-0658
Pengembangan sistem manajemen pengawasan jaringan berbasis modul dengan implementasi web service/ Yanto	Yanto	2007	SK-0689
Pengenalan Citra Sel Tunggal Pap Smear dengan Model Klasifikasi Adaptive-Network-based Fuzzy Inference System dan Biomedical Image Retrieval System/ Ratih Amalia 	Ratih Amalia	2007	SK-0692
Pengenalan wajah entitas bernama menggunakan metode association rules pada dokumen berbahasa Indonesia/ Markus	Markus	2007	SK-0660
Penggunaan associations rules dalam pengembangan standar dokumen legas Indonesia berbasis XML dengan studi kasus dokumen Undang-undang Republik Indonesia/ Ahlijati Nuraminah	Ahlijati Nuraminah	2007	SK-0665
Penjadwalan perkuliahan dengan pendekatan constraint programming/ Dania Tarigan Soraya	Dania Tigarani Soraya	2007	SK-0667
Perancangan digital dashboard system untuk menyajikan key performance indicators: studi kasus bidang riset dan penelitian Fak. Ilmu Komputer UI/ Edwin Richardo	Edwin Richardo	2007	SK-0685
Perbanding kinerja algoritma agglomerative hieracchical pada document clustering/ Catur Adi Nugroho	Catur Adi Nugroho	2007	SK-0662
Perbandingan decision tree, maximum entropy, dan association rules pada resolusi koreferensi untuk bahasa indonesia/ Astria Kurniawan Sumantri	Astria Kurniawan Sumantri	2007	SK-697
Perbandingan metode evaluasi kurvatur dalam menentukan bentuk permukaan bidang pada model faset 3D/ Priadhana Edi Kresnha	Priandhana Edi Kresnha	2007	SK-0683
Peringkas otomatis untuk dokumen dalam bahasa Indonesia menggunakan metode statis dan metode query-biased/ Ade Melani	Ade Melani	2007	SK-0681
Proses segmentasi citra sel tunggal Pap Smear menggunakan metode automatic fuzzy C-means clustering/ Richard Lokasasmita	Richard Lokasasmita	2007	SK-0693
Prototipe sistem perolehan citra dengan kueri bentuk/ Bayu Pramono Sukarno	Bayu Pramono Sukarno	2007	SK-698
Sistem kembali citra wajah berbasis eigenface/ Nova Eka Diana	Nova Eka Diana	2007	SK-0682
Studi banding klasifikasi citra sel tunggal Pap Smear berdasarkan metode minimum distance, jaringan saraf tiruan, least square, dan nearest class gravity center/ Dini Addiati	Dini Addiati	2007	SK-0676
Studi banding metode klasifikasi citra sel tunggal pap smear menggunakan neural network dan support vector machine/ Phyllisia A.	Phyllisia A.	2007	SK-0694
Studi banding segmentasi citra set tunggal Pap Smear berdasarkan metode fuzzy C-Means clustering, thresholding, dan transformasi watershed/ Titin Farida	Titin Farida	2007	SK-0678
Verifikasi protokol autentifikasi Andrew secure RPC dengan proverif/ Pamela Indrajati	Pamela Indrajati	2007	SK-0655
Analisis dan uji coba alokasi sumber daya pada komputasi grid berbasiskan globus toolkit dan grid engine	Jefri Abdullah	2006	SK-0633
Aplikasi dan analisis clustering pada data akademik	Andina Budiarti	2006	SK-0619
Deteksi wilayah yang dicurigai kanker pada citra mamogram dengan mengeliminasi struktur curvilinear	Dwiyani Rahmawati	2006	SK-0627
Eksplorasi pembuatan services di atas globus toolkit 4 dengan studi kasus perkalian matriks secara terdistribusi	Sirajudin Maizir	2006	SK-0639
Evaluasi lingkungan programan paralel berbasis message passing interface dalam infrastruktur komputasi grid di Universitas Indonesia	Fajran Iman Rusadi	2006	SK-0636
Event extraction pada teks berbahasa indonesia melalui pendekatan machine learning: perbadingan metode association rules, decision tree, dan neural networks	M. Fatkhul Amin	2006	SK-0634
Image information mining pada aplikasi remote sensing	Eka Aditya	2006	SK-0631
Jarak proyeksi-titik-uji ke titik ciri dalam sistem penentu sudut pandang menggunakan metode nearest feature line/ Muhammad Rusdi Syamsuddin	Muhammad Rusdi Syamsuddin	2006	SK-0643
Kajian watermarking digital dengan metode modulasi amplitudo pada citra biomedik, logo, foto dan remote sensing/ Arnold Wiliem	Arnold Wiliem	2006	SK-0630
Me-Render efek pelangi dan korona pada pemandangan alam secara real time dengan high level shading language	Aristo	2006	SK-0625
Pemilihan threshold dan kriteria token pada email filtering menggunakan algoritma naive bayesian	Jos Timanta Tarigan	2006	SK-0640
Pencarian halaman web menggunakan informasi dan metadata pada halaman web/ Rama Pandugita	Pandugita, Rama	2006	SK-0614
Penelitian dan penerapan algoritma-algoritma association rules dalam pengembangan data mining algorithms collection	Muhammad Fahrian	2006	SK-0646
Penemuan jawaban pada dokumen berbahasa Indonesia	Dessy Natalia	2006	SK-0632
Penerapan automatic summarization memakai motde text extraction dengan menggunakan centroid value, positional  value dan first sentence overlap untuk artikel ilmiah berbahasa Indonesia	Hendrik Ganda Wijaya	2006	SK-0648
Penerapan item response theory pada adaptive online test system dengan proses estimasi parameter soal: studi kasus tes potensi Akademik/ Puspita Kencana Sari	Puspita Kencana Sari	2006	SK-0624
Penerapan teknik e-mail filtering berbasis ekstraksi ciri dan jaringan saraf tiruan propagasi balik	Johanes Andria	2006	SK-0649
Pengembangan customer relationship management system berbsis expert system: studi kasus kerusakan pada telepon seluler	Risvan Ardiansyah	2006	SK-0647
Pengembangan modul container-station dengan metode B	Ahmad Furqan S.K.;  | Publisher: Depok	2006	SK-0626
Pengembangan modul container-station dengan metode B/ Ahmad Furqans K	Ahmad Furqans K.	2006	SK-0626
Pengembangan prototype laboratorium online berbasis layanan grid studi : kasus eksperimen pengambilan keputusan dengan analisis pareto pada data terdistribusi	GST Agus Komang Lastrawan	2006	SK-0638
Pengembangan standar dokumen legal indonesia berbasis XML menggunakan sistem ekstraksi informasi dengan studi kasus dokumen Undang-undang Republik Indonesia/ Siti Mawadah	Siti Mawadah	2006	SK-0645
Penggunaan model ruang vektor dalam proses pengenalan relasi antar entitas pada sistem ekstraksi informasi	Kiki Marjuki	2006	SK-0629
Pengklasifikasian artikel berita berbahasa indonesia secara otomatis menggunakan naive bayes classifier/ Sylvia Susanto	Sylvia Susanto	2006	SK-0623
Pengklasifikasian secara otomatis berbasiskan centroid pada abstrak berbahasa Indonesia/ Natalia Komalasari	Natalia Komalasari	2006	SK-0622
Peningkatan kinerja pencarian dokumen dalam sistem peer-to peer dengan memanfaatkan kemiripan koleksi dokumen antar peer	Yudhi M. Hamzah K	2006	SK-0654
Perancangan dan implementasi data warehouse untuk data sistem informasi akademik Universitas Indonesia menggunakan oracle warehouse builder ver. 10.1.0.4.0	Antonius Hermawan	2006	SK-0620
Perancangan dan ujicoba grid information retrieval	Dimas Julian M.R	2006	SK-0641
Perancangan sistem high-throughput computing melalui penggunaan job scheduler condor dalam infrastruktur komputasi grid	Josef	2006	SK-0637
Proses verifikasi piranti lunak menggunakan lingu dan theorem prover hol pada studi kasus student entrance test/ Carroline D. Puspa	Carroline D. Puspa	2006	SK-0621
Protokol penandatanganan kontrak optimistik asokan-shoup-waidner	Nilam Fitriah	2006	SK-0652
Refinement dengan metode B pada pengembangan modul aplikasi perbankan/ Theresia Budiyanti	Theresia Budiyanti	2006	SK-0611
Registrasi citra secara otomatis pada aplikasi remote sensing	Gunawan	2006	SK-0628
Sistem pengenalan wajah 3D sudut vertikal dan sudut horizontal menggunakan metode nearest feture line pada kombinasi ruang eigen double view based/ Christian K.F. Daeli	Christian K.F Daeli	2006	SK-0642
Sistem perolehan gambar lintas bahasa berdasarkan isi dan teks yang terkait dari gambar/ Framadhan Arnely	Framadhan Arnely	2006	SK-0613
Sistem perolehan informasi geografis untuk dokumen berbahasa Indonesia	Monica Lestari Paramita	2006	SK-0635
Uang digital offline	Imelda Tandra	2006	SK-0610
Verifikasi protokol otentikasi Horn-Preneel menggunakan A VISPA (Automated Validation of Internet Security Protocols and Applications)	Ilham Kurnia	2006	SK-0618
Analisis aspek keamanan jaringan Wi-Fi di lingkungan Fakultas Ilmu Komputer Universitas Indonesia/ Liong Sauw Fei	Liong Sauw Fei	2005	SK-0574
Aspek keamanan dari sistem GRID studi kasus: Grid Security infrastructure (GSI) pada globus toolkit 3 9GT3)	Haryanto	2005	SK-0578
Grid Virtual File System/ Suryo Gumilar	Suryo Gumilar	2005	SK-0577
Implementasi stax api versi 1.0 pada parser apache xerces-J-2-6.2/ Afrisal Akmal	Akmal, Afrisal	2005	SK-0589
Implementasi voice-over-ip di Universitas Indonesia: Studi Kasus Fakultas Ilmu Komputer/ Fajar Muharisa	Fajar Muharisa	2005	SK-???
Klasifikasi dan visualisasi hasil fusi citra berbasis piksel untuk citra resolusi berbeda/ Muhammad Zaki Rahman	Muhammad Zaki Rahman	2005	SK-0612
Metode pollard RHO dan aplikasinya pada penyelesaian IFP (Integer factorization problem) dan ECDLP (Elliptic curve discrete logarithm problem)/ Toni Sutomo	Sutomo, Toni	2005	SK-0593
Optimisasi perkalian sparse matrix-vektor menggunakan compresed storage row/ Charles Gunawan	Charles Gunawan	2005	SK-0605
Pemotong  imbuhan berdasarkan korpus untuk kata Bahasa Indonesia/ Muhammad Ichsan	Muhammad Ichsan	2005	SK-0615
Penelusuran Informasi  dengan agent-based referral network/ David	David	2005	SK-0588
Penerapan Konsep Mekanika Kolaborasi dalam Pengembangan Prototipe Shared Workspace /Windiantoro 	Windiantoro	2005	SK-0596
Penerapan bayesian network student model pada intelligent tutoring system/ Sari Widya Sihwi	Sari Widya Sihwi	2005	SK-0601
Penerapan item response theory yang dikominasikan dengan kingsbury and zara procedure pada adaptive test system/ Inge Evita Putri	Inge Evita Putri	2005	SK-0587
Penerapan teknik N-Term indexing (INT) pada pemilihan koleksi dalam distributed information retrieval system/ Husnul Rizka Mubarikah	Mubarikah, Husnul Rizka	2005	SK-0585
Pengembangan use case scenario berdasarkan deskripsi tekstual use case menggunakan pengenalan entitas bernama/ Mirnasari Dewi	Mirnasari Dewi	2005	SK-0595
Pengenalan Entitas Bernama menggunakan Metode Association Rules dengan Fitur Berganda/Budiono Wibowo 	Budiono Wibowo	2005	SK-0594
Pengenalan entitas bernama menggunakan hidden markov model dengan vitur morfologi dan kelas kata/ Arif Irawan	Arif Irawan	2005	SK-0575
Pengujian three-parameter model dari item response theory dalam computer adaptive test	Satrio Baskoro Yudhoatmojo	2005	SK-0608
Perancangan Komputer Pemesanan Makanan nan untuk Restoran Berbasis Handheld Computer (PDA)/ Arief purnama L.K. (1201000172)	Arief Purnama L.K.	2005	SK-0590
Perancangan aplikasi data mining untuk kegiatan akademik di Universitas Indonesia	Fatma, Rizka Nadia	2005	SK-0579
Perancangan data warehouse untuk kegiatan akademik di Universitas indonesia/ Hanny Faristin	Hanny Faristin	2005	SK-0591
Perancangan grid environment di lingkungan Fakultas Ilmu Komputer UI/ Mika Permana	Mika Permana	2005	SK-0599
Peringkas otomatis untuk dokumen berbahasa Indonesia dengan metode frase penunjuk dan metode TF-IDF/ Haryani Diah Sitawati	Haryani Diah Sitawati	2005	SK-0603
Sistem monitoring sumber daya hardware berbasis web untuk public cluster LIPI	Slamet	2005	SK-0606
Sistem tanya jawab: Penemuan jawaban pada passage/ Rinawati	Rinawati	2005	SK-0607
Studi Evaluasi Kinerja FILE Transfer di Atas Protokol TCP dengan menggunakan WINSOCK 2.2./ Herman Hartono	Herman Hartono	2005	SK-0597
Visualisasi perhitungan kontrak opsi saham dengan formula black-scholes/ Irvan Helmi	Irvan Helmi	2005	SK-0592
Adaptive workflow management system untuk menangani perubahan pada struktur organisasi	Talaway, Irene P.	2004	SK-0555
Analisa perencenaan implementasi jaringan nirkabel di fak. Ilmu Komputer Universitas Indonesia/ Mirta Amalia	Mirta Amalia	2004	SK-0561
Aplikasi algoritma hough transform untuk enstraksi fitur-fitur penting pada wajah/ Siti Uwatun Hasanah	Siti Uswatun Hasanah	2004	SK-0569
Appointment planner berbasis embedded system/ Jermias Perkasa	Perkasa, Jermias	2004	SK-0556
Implementasi aplikasi contex-aware dalam lingkungan  pervasive computing menggunakan UPnP network/ Anisa Fitriyah Hadi	Anisa Fitriyah Hadi	2004	SK-0549
Implementasi dan analisis efisiensi beberapa algoritma kompresi teks terhadap aspek-aspek informasi tekstual/ Rian Yusran	Yusran, Rian	2004	SK-0552
Implementasi epipolar geometri dalam computer vision untuk pendeteksian titk korespondensi untuk konstruksi tiga dimensi	Masmei Ulinta G.	2004	SK-0560
Implementasi kriptografi kurva eliptik dengan basis normal optimal pada micronotroller atmel AVR/Oscar	Oscar	2004	SK-0553
Implementasi kriptografi kurva eliptik pada pengiriman SMS melalui telepon telepon seluler dengan teknologi J2ME/ Yusri	Yusri	2004	SK-0548
Implementasi location based service dengan bluetooth dan web service	Rikky Wenang Purbojati	2004	SK-0571
Implementasi metode cafe untuk indexing dan retrieval database genomik: uji kasus penerapan panjang gram yang berbeda-beda/ Christin	Christin	2004	SK-0547
Kriptografi kurva eliptik dan aplikasinya pada smartcard/ Wiratna S Wiguna	Wiratna Sari Wiguna	2004	SK-0542
Metode seleksi ciri sequential forward floating selection dengan algoritma genetika dan kombinasi keduanya untuk citra heperspetral	linda Yusnita	2004	SK-0554
Metrics calculator untuk sistem berorientasi objek/ Christariny	Christariny	2004	SK-0546
Pendeteksi batas kalimat teks berbahasa Indonesia berdasarkan informasi morfologi dan leksikal menggunakan jaringan saraf tiruan dengan algoritma backpropagation/ Ratna Kirana	Ratna Kirana	2004	SK-0562
Penentuan Kombinasi vektor eigen dalam pembentukan ruang ciri dengan algoritme genetika untuk sistem pengenalan wajah 3D menggunakan metode nearest feature line/ Haries Efrika	Haries Efrika	2004	SK-0566
Penentuan jenis kelamin manusia menggunakan analisa fourier dan analisa wavelet berdasarkan bentuk dahi manusia pada citra cephalomety/ Tirza Munisyawara	Tirza Munisyawara	2004	SK-0565
Penerapan dan evaluasi  segmented principal component transform pada citra hiper spektral reflectance dan radiance/ Jefree WHL Manurung	Manurung, Jefree WHL	2004	SK-0545
Penerapan prinsip blossoming pada kurva B-spline dan permukaan b-splin tensor product/ Lukman Salim	Lukman Salim	2004	SK-0550
Penerjemah bahasa fortran 77 ke bahasa java: manajemen struktur data	Susanto, Rudi	2004	SK-0557
Pengembangan aplikasi smart-home dengan akses global peer-to-peer networking diatas protokol JXTA/ Gladhi Guarddin	Guarddin, Gladhi	2004	SK-0543
Pengembangan prototype adaptive online test system	Lisa Reinellda Irsal	2004	SK-0573
Pengenalan  objek 3 dimensi menggunakan jaringan syarat tiruan dengan arsitektur spheric structure of hidden layer/Bayu Adianto Prabowo	Bayu Adianto Prabowo	2004	SK-0558
Pengenalan entitas bernama berdasarkan informai kontekstual morfologi dan kelas kata/ Gatot Wahyudi	Gatot Wahyudi	2004	SK-0564
Pengenalan wajah dengan variasi sudut pandang vertikal horisontal menggunakan Jaringan syarag tiruan Hemispheric structure of hidden layer	Barkah Yusuf Widodo	2004	SK-0576
Penggunaan jaringan neural buatan metode PPN dan logika fuzzy untuk sistem pengenal huruf tulisan tangan/ Adhi Putra	Putra, Adhi	2004	SK-0581
Pengujian konsistensi xalan terhadap spesifikasi XSLT 1.0 (XML Stylesheet Language for Transformation) dan penuangan cara kerja xalan dalam bentuk diagram-diagram UML (Unified Modelling Languge)/ Rhama Arya Wibawa	Wibawa, Rhama Arya	2004	SK-0644
Protokol identifikasi challenge response dengan implementasinya berupa passcode generator pada platform J2ME dan bluetooth	Wisnu Murdiono	2004	SK-???
Protokol indentifikasi zero knowledge dan aplikasinya pada smart card	Wiwit Hermawan	2004	SK-0563
Rancangan arsitektur dan infrastruktur pada sistem GRID/ Mitchel Hamilton	Michel Hamilton	2004	SK-0559
Studi banding implementasi java RMI dan java corba pada sistem terdistribusi dengan kasus komputasi numerik/Iis Haryono	Haryono, Iis	2004	SK-0551
Analisis kinerja implementasi beberapa struktur tabel simbol pada suatu kompilator memakai tools berbasis java/ Ruli Yusran	Rull Yusran	2003	SK-0536
Aplikasi xWatch paralel berbasis message passing/ Rolis Kartiko	Kartiko, Rolis	2003	SK-0528
Cellular automata: pemodelan dan implementasi paralel untuk simulasi arus lalulintas kendaraan di Jalan raya	Syalim, Amril	2003	SK-0530
Implementasi Protokol Universal Plug and play berbasis OSGi Framework/ Agustina	Agustina	2003	SK-0524
Implementasi constructive solid geometry (CSG) dengan metode ray tracing/ Kusumasari  Dwiana	Kusumasari, Dwiana	2003	SK-0527
Implementasi open service gateway initiative framework specification release 3/ Rahmat Bagas Santoso	Santoso, Rahmat Bagas	2003	SK-0535
Pemodelan daun dengan l-system/ Kiki Pratiwi	Pratiwi, Kiki	2003	SK-0522
Penerapan design patterns untuk implementasi alat bantu  requirements management berbasis komputer genggam/ A. Sasmito Adibowo	Adibowo, A. Sasmito	2003	SK-0533
Penerjemahan Kode Numerik: Bahasa Pemrograman Fortran 77 ke Java ( Numerical Fortran Code to Java Translator)/ Jimmy	Jimmy	2003	SK-0531
Pengembangan aplikasi sinkronisasi kalender berbasis SynCML dengan infrastruktur bluetooth dan UPNP	Ari Hermawan	2003	SK-0541
Pengembangan metode fusi informasi untuk memperbaiki citra tematik/ Wisnu Adiarso Indrasworo	Indrasworo, Wisnu Adiarso	2003	SK-0525
Pengenalan wajah 3D menggunakan algoritma jaringan saraf tiruan SOM (self-organizing MAP)	Mariana D Triagni R	2003	SK-749
Penggunaan pendekatan component-based software engineering(CBSE) untuk mengembangkan e-catalogue sebagai komponent perangkat lunak/Yoga Nandiwardhana	Nandiwardhana, Yoga	2003	SK-0582
Peningkatan kualitas citra berdasarkan tingkat homogenitas	Ari Widayanti	2003	SK-0532
Perancangan dan pengembangan sistem indek untuk dokumen berbasis XML/ Jutedy	Jutedy	2003	SK-0534
Rancangan dan implementasi aplikasi remote phonebook dan smart messaging/ Arianto Catur Nugroho	Nugroho, Arianto Catur	2003	SK-0529
Sistem temu kembali informasi berbasis fuzzy logic dengan memanfaatan korelasi antar istilah/ W. Hanendyo	W, Hanendyo	2003	SK-0521
Alat bantu requirements management berbasis WEB dengan memanfaatkan dokumen extensible MARKUP language/ Zurlfikar Satria Darmawan	Dharmawan, Zulfikar Satria	2002	SK-0475
Analisa fungsi fitness pada algoritma genetika untuk optimasi JST-BP berdasarkan transformasi karhunen Loeve: studi kasus pada sistem pengenalan citra tumor kulit/ Dewi Puspita Sari	Sari, Dewi Puspita	2002	SK-0502
Analisa reduksi dimensi citra untuk menentukan sudut pandang obyek wajah tiga dimensi menggunakan metode nearest feature line/ Nisfia Marliani A.	Marliani A, Nisfia	2002	SK-0495
Analisa transformasi eigen pada penentuan sudut pandang suatu objek tiga dimensi dengan variasi sudut elevasi menggunakan metode nearest feature line/ Eko Prasetio	Prasetio, Eko	2002	SK-0503
Aspect-oriented programming (AOP) untuk menangani masalah pada software modularity/ Qonita MH Shahab	Shahab, Qonita MH	2002	SK-0486
Deteksi sisi pada citra berstruktur berdasarkan konsep sudut bebas/ Eko Prasetyo	Prasetyo, Eko	2002	SK-0499
Eksposisi metode adler-comppersmith-Hassner (ACH) untuk membentuk encoder pada Run-Lenght Limited (RLL) Constrained System/ Agus Syawal Yudhistira	Yudhistira, Agus Syawal	2002	SK-0512
Framework untuk pertukaran data dalam format XML antara course manager dan resource module dalam sistem CML untuk kurikulum PDPT UI	Rina Adriani	2002	SK-0484
Implementasi dan evaluasi algoritma skeletonizing berbasis distance transform berdasarkan metode HU-NOWINSKI	Edi	2002	SK-0511
Implementasi dan studi perbandingan metode eigenface dan fisherface dalam metode nearest feature line untuk pengenalan wajah 2 dimensi/ Fitria Agustina	Agustina, Fitria	2002	SK-0493
Implementasi iterasi Runge-Kutta dengan block Triangular jacobian menggunakan fixed stepsize dan variable stepsize/ Hermawi	Hermawi	2002	SK-0482
Implementasi metode kato-yasuhara untuk menemukan kembali alur penulisan citra tulisan tangan single-stroke	Hianda	2002	SK-0497
Implementasi penghalusan objek permukaan tiga dimensi berbasis segitiga dengan algoritme loop/ Hendry	Hendry	2002	SK-0496
Kajian metode segmentasi citra berdasarkan algoritma pyramida seeded region growing, seeded region growing, dan pixel aggregation	Dipdha Yasienta	2002	SK-0510
Kinerja PPN-teroptimasi berbasis algoritma genetika dalam pengenalan aroma 2 campuran/ Herry	Herry	2002	SK-0539
Modul histoby dan forum diskusi pada web-based concept mapping/ Achmad Bachtiar	Bachtiar, Achmad	2002	SK-0481
Optimasi jaringan saraf tiruan propagasi balik untuk pengenalan aroma campuran menggunakan algoritma genetika	Sansuadi	2002	SK-0468
Pemeriksa abstrak berbahasa Indonesia	Luthfy Andriansyah	2002	SK-0494
Pemodelan pohon dengan l-system/ Monis Moriana	Moriana, Monis	2002	SK-0478
Penelitian pendahuluan pengembangan penganalisa korpus bahasa Indonesia/ Bramono Indratno	Indratno, Bramono	2002	SK-0489
Penerapan algoritma genetika untuk penentuan ciri optimal pada representasi eigenfance dalam sistem pengenalan wajah dengan metode nearest feature line/ Adila Alfa Krisnadhi	Adila Alfa Krisnadhi	2002	SK-0538
Penerapan dekomposisi semi diskrete dan nilai singular untuk peningkatan kinerja sistem temu kembali informasi	Mohammad Fauzan T	2002	SK-0508
Penerapan konsep application servuce provider dalam virtual software industry/ Syarif Hidayatullah	Hidayatullah, Syarif	2002	SK-0483
Penerapan pengklasifikasi geometrik tetangga dekat berdasarkan ciri spektral dan ciri spasial	Arief Setiawan	2002	SK-0509
Penerapan sistem manajemen workflow untuk melakukan otomasi proses bisnis dalam studi kasus klaim Asuransi Mobil/ Hendrik	Hendrik	2002	SK-0505
Pengembangan aplikasi e-lelang berbasis komponen melalui teknologi enterprise javabean/ Muhammad Rofiq	Rofiq, Muhammad	2002	SK-0474
Pengembangan lanjut grafis antarmuka pengguna pada web-based concept mapping/ Rizky Yulianto P.	Yulianto P, Rizky	2002	SK-0572
Pengembangan lanjut pengurai struktur kalimat bahasa Indonesia yang menggunakan constraint-based formalism	Joice	2002	SK-0487
Pengembangan pengurai morfologi untuk bahasa Indonesia dengan model morfologi dua tingkat berbasiskan PC-KIMMO/ Hendra Hartono	Hendra  Hartono	2002	SK-0516
Pengembangan piranti bantu perhitungan harga obligasi dengan model Stochastic Term Stucture of Interest Rates/ Farindra Tamin	Tamin, Farindra	2002	SK-0507
Pengembangan piranti lunak bantu perhitungan opsi dengan metode black-scholes dan merton's jump deffusion/ Dewi Meiriza	Meiriza, Dewi	2002	SK-0477
Pengenalan aroma 2 dan 3 campuran menggunakan jaringan neural buatan berbasis logika fuzzy dan optimasi algoritma genetika dengan pembanding metode FLVQ/ Muhammad Hasan	Hasan, Muhammad	2002	SK-0520
Pengenalan aroma baru yang tidak diketahui (UNKNOWN) 2 campuran dan 3 campuran 16 sensor dengan menggunakan FLVQ dan analisa matriks similatiras/ Komara Hidayat	Hidayat, Komara	2002	SK-0498
Pengenalan wajah 3 dimensi menggunakan data cropping dalam JST CHMLP-BP berbasis algoritma genetika	Sri Ayu Lestari	2002	SK-0492
Penggunaan pendekatan component-based software engineering (CBSE) untuk mendukung teknik pengembangan berorientasi obyek dalam peneranan aplikasi e-business/ Ratih Adriani	Adriani, Ratih	2002	SK-0491
Pengolahan kurva B-spline dari sudut pandang teknik blossoming/Tony	Tony	2002	SK-0517
Pengukuran kinerja router berbasis sistem operasi GNU/LINUX dengan menggunakan metode eksplorasi sederhana/ Ainul Fitriyah	Fitriyah, Ainul	2002	SK-0485
Peningkatan pengenalan wajah 3 dimensi menggunakan data cropping dengan JST CHMLP-BP konsentris dan metode eigenface berbasis algoritma genetika/ Rini Dyah Astuti	Astuti, Rini Dyah	2002	SK-0480
Perancangan proses bisnis UI-Trust certification authority berdasarkan standar international/ Ondolan Saut Pangindoan Siringo-ringo	Siringo-ringo, Ondolan Saut Pangidoan	2002	SK-0445
Studi fungsi fitness pola algoritma genetika untuk peningkatan derajat pengenalan objek 3D dan optimasi struktur jaringan neural HSHL/ Rahmat Kurniawan	Kurniawan, Rahmat	2002	SK-0506
Studi kasus penerapan aspect-oriented programming (AOP) dalam menangani cross-cutting concerns pada programming library penggambaran  diagram statistik: chart2d/ Rio Rinaldi	Rinaldi, Rio	2002	SK-0513
Study kinerja JST CHMLP-BP dengan fungsi kesalahan cros entropy dan fungsi kesalahan mean square error untuk pengenalan objek tiga dimensi/ Nana Sumpena	Sumpena, Nana	2002	SK-0514
Visualisasi pemodelan arus lalu-lintas pada sebuah ruas jalan dengan1 pendekatan model kontinum sederhana	Hendrie Gunawan	2002	SK-0500
Alat bantu pencarian design pattern dengan menggunakan siste pakar/ Ronggo Gundala Yuda	Yudha, Ronggo Gundala	2001	SK-0466
Algoritma genetika transposisi untuk optimasi sistem pengenalan wajah 3 dimensi menggunakan JST CHMLP-BP konsentris dan metode eigenface/ Leila Fatmasari Rahman	Rahman, Leila Fatmasari	2001	SK-0453
Cellular automata: pemodelan dan implementasi	Hanna Kurniawti	2001	SK-0463
Deteksi tepi pada citra dijital dengan menggunakan adaline multi-state/Eko Yuli Kuswoyo	Kuswoyo, Eko Yuli	2001	SK-0451
Faktorisasi polinomial univariabel dengan algoritma berlekamp dan algortima hensel lifting/Endarwaty	Endarwaty	2001	SK-0448
Implementasi Jaringan Hibrida SWA-Organisasi Adaptif untuk Pengelompokkan Jenis Dokumen pada Sistem Temu Kembali Informasi/ Ari Faizal Aliani	Aliani, Ari Faizal	2001	SK-0616
Implementasi paralel dari transformasi wavelet pada cluster beowulf dengan MPI (message passing interface)/ Fajar Yulian	Yulian, Fajar	2001	SK-0464
Implementasi perangkat lunak pengolahan citra dengan kemampuan snap-ins pada platform windows/ Ivan	Ivan	2001	SK-0440
Implementasi sekuensial algoritma thinking parallel penuh/ Idauli Laurens Tamarin	Idauli Laurens Tamarin	2001	SK-0540
Kompresi citra menggunakan modifikasi lossy dari algoritma lempel-ZIV	Daniel Baktiar	2001	SK-0664
Komputasi CGD polinomial satu peubah dengan homomorfisme hensel lifting/ Selpi	Selpi	2001	SK-0447
Network plug and play embedded system pada home smart applications berbasis jini	R. Adhari C Mahendra,	2001	SK-0462
Online assistant untuk penerapan bahasa Indonesia baku pada RMUC/ Felix Ciptadi Nugroho	Nugroho, Felix Ciptadi	2001	SK-0476
Optimasi pengenalan aroma 3 campuran pada jaringan neural buatan berbasis logika fuzzy menggunakan algoritma genetika	Iskandar Rizki	2001	SK-0470
Pemetaan structural knowledge manusia menggunakan teknik concept mapping berbasis web/ Yudhi Prasetyo	Prasetyo, Yudhi	2001	SK-0515
Penentuan sudut pandang suatu objek tiga dimensi dengan menggunakan metode nearest feature line/Rina Sripomo	Sripomo, Rina	2001	SK-0456
Penerapan algoritma genetika pada inisialisasi pelatihan jaringan syaraf tiruan propagasi balik/ Rulli Chandra M.	Chandra M, Rulli	2001	SK-0449
Penerapan rule base system pada paket archiew 3.1 untuk identifikasi kawasan sentra produksi/Aziefah	Aziefah	2001	SK-0450
Pengembangan agen SNMP untuk tini embedded system/ Badai Aqrandista	Aqrandista, Badai	2001	SK-0446
Pengembangan aplikasi embedded linux menggunakan ecos (embedded configurable operating system)/Piteir	Piteir	2001	SK-???
Pengembangan jaringan syaraf tiruan dengan optimasi algoritma genetika untuk pengenalan citra tumor kulit/ Like Sisca	Sisca, Like	2001	SK-0472
Pengembangan sistem informasi saham dari berbagai sumber data dengan berbasis XML	Oktavia Widajadi	2001	SK-0452
Pengenalan objek 3 dimensi dengan menggunakan jaringan syaraf tiruan hemisphere structure of hidden layer/ Galuh Dian Maulana	Maulana, Galuh Dian	2001	SK-0461
Pengenalan objek 3 dimensi menggunakan jaringan syaraf tiruan hemisphere strukture of hidden layer dalam ruang eigen	Yanuarisa Kariani	2001	SK-0460
Peningkatan pengenalan objek dan wajah 3 dimensi menggunakan eige171n parsial dalam JST CHMLP-BP konsentris berbasis algoritma genetika/ Sumiyati	Sumiyati	2001	SK-0473
Penyelesaian masalah vehicle routing and scheduling dlam dunia nyata berdasarkan metode algoritma genetika - simulated annealing/ Emiliana Dewi Aryani	Aryani, Emiliana Dewi	2001	SK-0459
Perancangan dan pengembangan optimasi jaringan saraf hibrida dengan menggunakan algoritma genetika serta aplikasinya pada pengenalan aroma	Willi Widiatmiko	2001	SK-0469
Perancangan penalisis struktur kalimat bahasa Indonesia, khususnya frasa verbal, dengan menggunakan constraint-based formalism berbasis feature structures dan unification, dan penerapannya pada dokumen resmi/ Selly Meliana	Meliana, Selly	2001	SK-0457
Perancangan pengalisis struktur kalimat bahasa Indonesia dengan menggunakan constraint-based formalism berdasarkan features structures dan unification dan penerapannya pada makalah ilmiah/  A. Jibra Shidqie	Shidqie, A. Jibran	2001	SK-0458
Perancangan penganalisis struktural kalimat bahasa Indonesia, khususnya frasa nominal, dengan menggunakan constraint-based formalism, dan penerapannya pada media Massa elektronika/ I Made Dwijendra Sulastra	Sulastra, I Made Dwijendra	2001	SK-0501
Sistem pengenalan obyek tiga dimensi dengan metode enigenface pada JST CHMLP-BP dengan optimasi algoritma genetika tanpa informasi sudut pandang	Bayuadhi Indrayana	2001	SK-0504
Studi perbandingan sistem ekstraksi informasi berbahasa Indonesia/ Yuliana Kenyo Sejati	Sejati, Yuliana Kenyo	2001	SK-0490
Transformasi wavelet dengan metode lifting/ Defa Trio	Trio, Defa	2001	SK-0429
Visualisasi pergerakan benda di atas permukaan Es	Anita	2001	SK-0479
Alat bantu kolaborasi pemrograman menerapkan model chckout/checkin berbasis web/ Anton Suryadi	Suryadi, Anton	2000	SK-0422
Alat bantu materialisasi view dan indeks pada data warehouse untuk menunjang aplikasi OLAP/Agung Kurniawan	Kurniawan, Agung	2000	SK-0410
Analisis metode self organizing map dan differential competitive learning pada sistem pengenalan suara/ Dian Indrawaty	Indrawaty, Dian	2000	SK-0441
Ekspansi query menggunakan constraint spreading activation pada sistem temu-kembali informasi/ Indra Budi	Budi, Indra	2000	SK-0430
Implementasi agen pembantu mengingat (remembrance agent): studi kasus untuk sistem belajar berbasis web/ Verdi March	March,  Verdi	2000	SK-0432
Implementasi dan studi perbandingan: metode eigenface dan fisherface pada sistem pengenalan wajah/ Intan PV Simanjuntak	Simanjuntak, Intan PV	2000	SK-0434
Implementasi kedekatan istilah mengunakan kalimat dan frase pada sistem temu-kembali informasi/ Aditia Doni	Doni, Aditia	2000	SK-0436
Implementasi pengadaan barang secara elektronik (elektronik procurement) dalam sistem perdagangan di internet/ Abdul Aziz	Aziz, Abdul	2000	SK-0442
Implementasi protokol internet-link pada sistem operasi linux/ Melby N. Syamsuddin	Syamsuddin, Melby N.	2000	SK-737
Implementasi protokol pembuatan group signatures holger petersen	Simangunsong, Henry Luther Enrico	2000	SK-0444
Klasifikasi citra inderaja berdasarkan ciri tekstur semivariogram dan matriks co-occurrence/ Dina Chahyati	Chahyati, Dina	2000	SK-0421
Mengatasi gangguan awan pada citra optik dengan menggunakan teknik dithering/ Farah Rohima Rohmah	Rohmah, Farah Rohima	2000	SK-0584
Optimasi fuzzy learning vector quantization menggunakan 8 sensor untuk pengenalan aroma campuran/ Med Irzal	Irzal, Met	2000	SK-0518
Optimasi jaringan saraf tiruan propagasi balik untuk pengenaan citra wajah dua dimensi berbasis Fisherface menggunakan algoritma genetika/ Restomi	Restomi	2000	SK-0701
Pemampatan citra dengan membangun wavelet packet best tree berbasis entropi shandon/Rusdiana	Rusdiana	2000	SK-0424
Penambahan fasilitas modul jaringan dan pengembangan aplikasi sistem informasi geografis dengan fasilitas ARCVIEW/ Robby Partha	Partha, Robby	2000	SK-0427
Penerapan metode nearest feature line pada sistem pengenalan obyek tiga dimensi dalam ruang eigen/ Reza Fatahilah Shah	Shah, Reza Fatahilah	2000	SK-0443
Pengembangan e-catalogue dengan metode pengembangan berorientasi objek/ Hafiz	Hafiz	2000	SK-0431
Pengenalan objek wajah 3 dimensi dengan metode eigenfaces pada jaringan saraf tiruan CHMLP-BP konsentris/Johanes Amudi	Amudi, Johanes	2000	SK-0420
Pengenalan objek wajah 3 dimensi dengan metode fisherface pada JST CHMLP-BP konsentris dengan optimasi algoritma genetika/ Martha Yuliana Panggabean	Panggabean, Martha Yuliana	2000	SK-0416
Reasoning agent pada sistem personalisasi situs web/ Nancy Paat	Paat, Nancy	2000	SK-0428
Simulator java virtual machine (JVM) dengan GUI berbasis java swing	Denny	2000	SK-0471
Sistem key-recovery nilai barang	Raymond  Aribawono	2000	SK-0454
Sistem pengenalan plat nomor mobil menggunakan pencocokan pola dan jaringan saraf tiruan/ Darundriyo Djoko Widodo	Widodo, Darundriyo Djoko	2000	SK-0439
Sistem temu kembali informasi dengan mengimplementasikan indeks frase berbasis sintaksis, sistem peringkat, dan pemrosesan query berbasis frase/ Siti Rohmah	Rohmah, Siti	2000	SK-0580
Software agent berbasis algoritma clustering hirarkis untuk personalisasi situs web/ Ika Alfina	Alfina, Ika	2000	SK-0433
Temu-kembali suara-kata asli dari suara-kata terganggu dengan transformasi wavelet	Abdul Hadie	2000	SK-823
Algoritma successive overrelaxtion (SOR) backpropagation untuk perbaikan metode pelatihan pada sistem pengenal huruf tulisan tangan/ Elsiany Salomy	Salome, Elsiany	1999	SK-0407
Analisa protokol pembayaran antara cardholder dan mercahnt pada protokol secure electronic transaction serta implementasi object library pendukungnya/ Dwianda Prayudi	Prayudi, Dwianda	1999	SK-0423
Analisis Tekstur Citra Brodatz dan Citra Radar Berbasis Fraktal/ Linda Rostiviani	Rostiviani, Linda	1999	SK-0292
Data mining dengan metode pencarian association rule	Elis	1999	SK-0390
Ekspansi Query pada sistem temu kembali informasi yang menggunakan inference network berbasis probabilitas/ Ade Azurat	Azurat, Ade	1999	SK-0405
Impelemtasi prototipe proses otorisasi kartu pembayaran antara merchant danpyment gateway protokol secure electronic transaction/ I Arif Priharsanta	Priharsanta, I Arif	1999	SK-0415
Implementasi pencarian berdasarkan bibliorafi pada sistem temu kembali informasi/Roni Hidayat	Hidayat, Roni	1999	SK-0397
Implementasi prototipe proses permintaan sertifikat X.500 pada protokol secure electronic transaction/Haris	Haris	1999	SK-0411
Jaringan neural buatan propagasi balik berbasis logika fuzzy studi kasus pada sistem penciuman elektronik/ Rakhmat Budi M	Budi M, Rakhmat	1999	SK-0406
Kinerja sistem temu-kembali informasi menggunakan model query basic term,  vektor, boolean dan extended boolean/Inayah Wardany	Wardany, Inayah	1999	SK-0398
Optimasi struktur jaringan neural buatan berbasis logika fuzzy menggunakan algoritma genetika	Ponix Irwanto	1999	SK-0393
Pemrograman dan obyek terdistribusi pada aplikasi piranti bantu bekerja sama/ Ahmad Nizar Hidayanto	Hidayanto, Achmad Nizar	1999	SK-0414
Penerapan teknik peringkasan otomatis dan text window sebagai alternatif peningkatan kinerja sistem pengindksan/ Ahmad Firdaus N.	Firdaus N, Ahmad	1999	SK-0387
Pengembangan Prototipe Perangkat Ajar Berbantuan Komputer yang Mendukung Penggunaan dan Pengembangan Strategi Belajar/Daniel Setiadi	Setiadi, Daniel	1999	SK-0309
Pengembangan group support system untuk pra-rapat asinkoronus dlam perencanaan strategis/ Dermawan Haris	Haris, Dermawan	1999	SK-0438
Pengembangan lanjut pengurai sintaks bahasa Indonesia dengan metode linguistic string analysis/Shelly Salvitri	Salvitri, Shelly	1999	SK-0417
Penggunaan transformasi fourier dan transformasi karhunen-loeve pada sistem pencocokan pola/ Elvi Fatma	Fatma, Elvi	1999	SK-0401
Pengurai sintaks kalimat untuuk bahasa Indonesia dengan metode linguistic string analysis/ Iskak Hendrawan	Hendrawan, Iskak	1999	SK-0388
Peningkatan kinerja jaringan saraf tiruan CHMLP dengan modifikasi struktur lapis tersembunyi untuk pengenalan objek 3 dimensi/ Renny Isharini R.	Isharini R, Renny	1999	SK-0391
Penyelesaian persamaan radiositas dengan metode wavelet/ Adianto Wibisono	Wibisono, Adianto	1999	SK-0419
Perancangan kamus kata konsep untuk sistem ekstraksi informasi berbasis bahasa alami (Indonesia)/ Muhamad Hasan Ismail	Ismail, Hasan Muhammad	1999	SK-0395
Rancangan keamanan data sistem smartcard kesehatan sesuai kebutuhan di Indonesia/ Christrine Sariasih	Sariasih, Christine	1999	SK-0409
Smartwallet-java wallet berbasis smartcard dan protokol set/ Iman Budi Setiawan	Setiawan, Iman Budi	1999	SK-0412
perancangan dan pengembangan jaringan saraf hibrida PB-SKNC serta aplikasinya pada pengenalan aroma/ Ari Saptawijaya	Saptawijaya, Ari	1999	SK-0394
Alternatif peningkatan kemampuan pemeriksa ejaan bahasa Indonesia/ H.M. Alvon Sibarani	Sibarani, H.M. Alvon	1998	SK-0363
Arsitektur lingkungan belajar dengan aplikasi pemahaman bacaan non linear yang mendukung strategi belajar aktif/ Ratna Shofianti	Shofiati, Ratna	1998	SK-0367
Formalisasi dan verifikasi sistem pengendali lalu lintas/ Manogari Simanjuntak	Simanjuntak, Manogari	1998	SK-0371
Implementasi deskripsi wavelet pada sistem temu kembali citra/Andi Tri Nugraha	Nugraha, Andi Tri	1998	SK-0366
Implementasi video konferensi pada xgroup/Ratna Juanita	Juanita, Ratna	1998	SK-0359
Integrasi simbolik dengan algoritma risch rekursif/ Alwen Fernanto	Fernanto, Alwen	1998	SK-0378
Integrasi simbolik dengan metode risch-norman dan implementasinya dalam maple/ Rochman Abdul	Rochman, Abdul	1998	SK-0370
Java api untuk smartcard ME2000/ Istofani Api Diany	Diany, Istofani Api	1998	SK-0375
Lingkungan verifikasi formal untuk program sekuensial dalam interactive theorem proverhol/ Octavianus Adrianto	Adrianto, Octavianus	1998	SK-0382
Pemampatan kamus kata: pengubahan struktur data digital tree menjadi directed acylic word-graph/ Ranatha B. Dharma	Dharma, Renatha B.	1998	SK-0377
Penentuan strategi belajar dan pembangunan pemodelan-strategi-belajar-siswa pada lingkungan belajar cerdas/ Mehrunnisah Kasim	Kasim, Mehrunisah	1998	SK-0365
Penerapan metode least square dalam persoalan pencocokan data dan analisa trend-residu medan gravitas/ Lamyarni Ibrahim	Ibrahim, Lamyarni	1998	SK-0041
Pengembangan jaringan syaraf tiruan berdasarkan transformasi karhunen-loeve untuk pengenalan citra tumor kulit/ Mayasari Tyas Palupi	Palupi, Tyas Mayasari	1998	SK-0400
Penggunaan jaringan neural buatan metode propagasi balik dan logika fuzzy untuk sistem pengenal huruf tulisan tangan/ Emanuel Philipus D.	Philipus D, Emanuel	1998	SK-0384
Penggunaan sistem penentu lebar ucapan, penyaring sinyal, dan proses filter bank pada pra pengolahan sistem pengenal kata jaringan Neural buatan dengan metode propagari balik/ Ipon Supriyono	Supriyono, Ipon	1998	SK-0402
Pengoreksi ejaan bahasa Indonesia untuk kata turunan dengan kesalahan pada afiks/ I Made Artana	Artana, I Made	1998	SK-0376
Perancangan dan implementasi komponen gerbang berbasis corba pada fasilitas integrasi informasi untuk sistem informasi eksekutif	M. Rahmat Widyanto,	1998	SK-0358
Perancangan dan implementasi siformasi script editor untuk pengembangan aplikasi berbasis MCSIR (Multisources Client Server Information Resource/Setyo Herry Purnomo	Purnomo, Setyo Herry	1998	SK-0372
Perancangan protokol lelang anonim menggunakan protokol kriptografis untuk medium elektronis/internet/ KGYID Pariantoro	Pariantoro, KGYID	1998	SK-0380
Prototipe alat bantu pemilihan view pada data warehouse berdasarkan algoritma greedy/ Teguh Raharjo	Raharjo, Teguh	1998	SK-0383
Prototipe pembuatan dan pemeliharaan view material dalam data werehouse/ Najib	Najib	1998	SK-0399
Rancangan dan implementasi modul pengarahan strategi belajar untuk pemahaman bacaan/ Bitri Indriany	Indriany, Bitri	1998	SK-0364
Sistem pengenaan tarif pemakaian perangkat lunak pada mekanisme software metering/ Fiftanto Harry	Harry, Fiftanto	1998	SK-0379
Sistem pengenalan huruf tulisan tangan dengan pendekatan heuristik/Purwanto	Purwanto	1998	SK-0306
Sistem penyaringan informasi pribadi dengan menggunakan modelruang vektor dan umpan balik relevansi/ Wahyu Hanito	Hanito, Wahyu	1998	SK-0381
Solusi sistem persamaan polinomial dengan basis grobner/Agusril	Agusril	1998	SK-0373
Studi keefektifan penggunaan teknik-teknik optimasi kueri basis data relasional pada data warehause/ Daryl N. Wirakartakusumah	Wirakartakusumah, Daryl N.;  | Publisher: [Depok: Fasilkom UI, 1998	1998	SK-0396
A-Map: Application Mapper untuk integrasi aplikasi bisnis pada penerapan electronic data interchage/ Mochamad Riza Achrulah	Achrulah, Mochamad Riza	1997	SK-0334
Alat bantu kolaborasi dalam prmrograman berorientasi obyek/ M. Arief Sofyandi	Sofyandi, M. Arief	1997	SK-0347
Formalisasi dan verifikasi protokol komunikasi/ Evita M. Sibarani	Sibarani, Evita M.	1997	SK-0337
Fusi citra dengan transformasi wavelet/ Haryanto Widjaja	Widjaja, Haryato	1997	SK-0346
Implementasi algoritme genetika pada sistem pengoreksi ejaan/ Sjariful Bahri	Bahri, Sjariful	1997	SK-0413
Implementasi algoritme pelacakan string dengan toleransi kesalahan pada modul pengoreksi ejaan Bahasa Indonesia/ Ariesusetyo Wibiksono	Wibiksono, Ariesusetyo	1997	SK-0352
Implementasi hidden markov model dalam sistem pengenal kata/ Dwi Purnamasari	Purnamasari, Dwi	1997	SK-0404
Implementasi layanan autentikasi pada IP next generation/ Didi Agung Laksono	Laksono, Didit Agung	1997	SK-0389
Implementasi local search engine pada sistem temu-kembali informasi/ Ananta Dwi Boedhitama	Boedhitama, Ananta Dwi	1997	SK-0362
Implementasi sistem temu kembali informasi menggunakan model boolean dengan fasilitas tesaurus/ Moh. Kolis Anshori	Anshori, Moh. Kholis	1997	SK-0425
Integrasi model checking dengan interactive theorem proving: pembuatan skrip pembuktian secara otomatis/ M. Eva Magdalena	M. Eva, Magdalena	1997	SK-0331
Jaringan syaraf tirual hofield dalam sistem temu kembali infomrasi/ Anung Barlianto	Barlianto, Anung	1997	SK-0368
Mekanisme software metering dengan teknologi objek tersebar/ Haemiwan Z. Fathony	Fathony, Haemiwan Z	1997	SK-0348
Pemampatan berkas suara dengan transformasi wavelet/Reginald Kuswanto	Kuswanto, Reginald	1997	SK-0342
Pemampatan citra dengan transformasi wavelet/ Hisar Maruli Manurung	Manurung, Hisar Maruli	1997	SK-0333
Pemanfaaatan applet java pada prototipe komponen kendali multisources client server information retrieval (MCSIR)/ Mario Benedictto	Benedictto, Mario	1997	SK-0345
Pemanfaatan applet java pada prototipe multisources client server information retrieval (MCSIR) dan aplikasi sistem informasi pimpinan Universitas (SIPINTAS)/ FFarian Ujong	Ujong, Farian	1997	SK-0332
Pembuatan aplikasi alur tugas berbasis intranet: studi kasus Prototipe Aplikasi Registrasi Domain Internet Indonesia ((PARDI)/Andi Santosa	Santosa, Andi	1997	SK-0353
Pemilihan strategi dan algoritme pemampatan data teks untuk kamus besar bahasa Indonesia elektronik/Ian Aditya Agus	Agus, Ian Aditya	1997	SK-0369
Penayangan citra multiresolusi pada wolrd wide web dengan transformasi wavelet/Adhimas Satianegara	Setianegara, Adhimas	1997	SK-0351
Pengelolaan berkas multimedia pada prototipe sistem manajemen basisdata multimedia/ Mohammad Sjarifuddin	Sjarifuddin, Mohammad	1997	SK-0339
Pengenalan citra tumor kulit menggunakan jaringan saraf tiruan dengan principal component analysis sebagai pemroses awal/ Aripin Ariyanto	Ariyanto, Aripin	1997	SK-0340
Perancangan dan implementasi modul percakapan dan modul catatan untuk perangkat ajar berbasis strategi belajar/ Oni Budipramono	Budipramono, Oni	1997	SK-0336
Perangkat lunak alat bantu pembuatan on-line help windows/ AAPA Yudha	Yudhana, AAPA Aryadipa	1997	SK-0350
Rancangan kamus kata untuk pemeriksa ejaan elektronis/ Ambara Horasi Febri	Horasi, Ambara Febri	1997	SK-0349
Sistem pendukung administrasi akademik berbasis lotus notes/ Agus Yudhy Priyanto	Priyanto, Agus Yudhy	1997	SK-0356
Sistem temu kembali informasi: Penghitungan asosiasi istilah dengan jaringan saraf/ Nurul Ainiyah	Ainiyah, Nurul	1997	SK-0403
Sistem temu-kemabli infomasi dengan mengimplementasikan operasi boolean, sistem peringkat, perbaikan query, dan pemanfaatan tesaurus/ Masayu Fitriyanti	Fitriyanti, Masayu	1997	SK-0357
Studi perancangan dan analisis formal protokol kriptografis untuk sistem pembayaran elektronis melalui internet/ Yenni Rahmita	Rahmita, Yenni	1997	SK-0335
Studi perbandingan sistem-sistem perdagangan di internett dan desain protokol, cek bilyet digital/ Arrianto Mukti Wibowo	Wibowo, Arrianto Mukti	1997	SK-0341
Teknik learning scheme berdasarkan model P-norm pada sistem temu kembali informasi/ Yofi Andri	Andri, Yofi	1997	SK-0361
XGroup+: media konferensi audio/Bambang Lestari	Lestari, Bambang	1997	SK-0360
Alat Bantu Pemrograman Berorientasi Obyek/Sugeng Warjianto	Warjianto, Sugeng	1996	SK-0310
Alat Bantu Pengujian Kelas Berbasis Spesifikasi/Andre Heru Irianto	Irianto, Andre Heru	1996	SK-0327
Alat bantu pembangkit dokumen hiperteks untuk dokumentasi analisis berorientasi obyek/ Muhammad Fadlisyah	Fadlisyah, Muhammad	1996	SK-0326
Alat bantu penyunting diagram EER dan pemetaan otomatis diagram EER ke deklarasi OODMS tertentu/ Noviari Sugianto	Sugianto, Noviari	1996	SK-0323
Alat bantu reusability kelas dan objek pada tahap analisis dan perancangan/ Yova Ruldeviyani	Rudeviyani, Yova	1996	SK-0315
Alat bantu untuk perencanaan strategei informasi/ Rehulina Tarigan	Tarigan, Rehulina	1996	SK-0330
Algoritma pelacakan teks dengan toleransi kesalahan dan implementasinya/Hendri	Hendri	1996	SK-0307
Evaluasi kinerja aplikasi microsoft visual C++ dan visual basic dengan studi kasus pengaksesan fort serial/ Setyadi Ivo	Ivo, Setyadi	1996	SK-0319
Implementasi Algoritma Quicksort pada PVM (Parallel Virtual Machine)/Marlyn Morina	Morina, Marlyn	1996	SK-0308
Implementasi algoritme fast fourier transform pada komputer paralel berbasis pertukaran pesan/P. Briliant M. Sitorus	Sitorus, P. Brilliant	1996	SK-0302
Implementasi algoritme merging dan matching untuk channel routing pada perancangan VLSI	Budi Handoko	1996	SK-886
Keamanan dan autentikasi pada telekonferensi X-Group/ Aneka Sulita	Sulita, Aneka	1996	SK-0320
Manajemen percakapan dan multicasting pada telekonferensi Xgroup/Benny Purnomo	Purnomo, Benny	1996	SK-0321
NetTOP: alat bantu pemodelan dan optimasi topologi wan (Wide Area Network)	Deddy	1996	SK-0314
PINOR: Piranti pelaksana normalisasi basis data relasional/ Novrita Andriani	Andriani, Novrita	1996	SK-0304
Pembuatan model aplikasi penghasil gambar animasi gerakan bibir dengan metode penganalan fonem berbasis jaringan SOM/Dicky Suryadi	Suryadi, Dicky	1996	SK-0318
Pemodelan pengetahuan siswa berbasiskan batasan-batasan pada materi persamaan linear dengan satu variabel/ Hadi Wisnu Pratowo	Pratowo, Hadi Wisnu	1996	SK-0316
Pemrosesan teks: penyusunan tesaurus secara otomatis dalam dalam bahasa Indonesia dengan analisis kluster hubungan lengkap (complete link)/Renata Magdalena	Magdalena, Renata	1996	SK-0325
Pengembangan prototipe sipintas dengan dukungan berbagai sumber informasi yang terintegrasi/Wibowo Santoso	Santoso, Wibowo	1996	SK-0294
Perancangan dan implementasi prototipe MCSIR (MultiSources Client-Server Information Retrieval)/ Desalina Sofianti	Sofianti, Desalina	1996	SK-0329
Perangkat bantu pengembangan perangkat ajar berbantuan komputer untuk bidang ilmu berbasis diagnosa: studi kasus pada bidang klinis/Paul J. Tuanakotta	Tuanakotta, Paul J.	1996	SK-0305
Prototip sistem workflow berbasis penyampaian pesan/ Iwan Mulyadi Kurniawan	Kurniawan, Iwan Mulyadi	1996	SK-0324
Simulasi perilaku industri manufaktur sederhana memakai metodologi berorientasi objek/Boyke Komara Putra	Putra, Boyke Komara	1996	SK-0317
Studi implementasi jaringan propagasi balik untuk diskriminasi odor/ Bayu Tenoyo	Tenoyo, Bayu	1996	SK-0313
Studi jaringan unix dengan basis TCP/IP/Rachmat Daradjat	Daradjat, Rachmat	1996	SK-0328
Transkriptor dari huruf latin ke huruf Jawa/Joseph Victor	Victor, Joseph	1996	SK-0312
Wahana Pemrograman Perangkat Lunak Aplikasi Berbasis Workflow/ Muhammad Helmy A.	Helmy A, Muhammad	1996	SK-???
Alat bantu interaktif untuk keperluan identifikasi wajah/ Feryson Darwis	Darwis, Feryson	1995	SK-0299
Analisa unjuk kerja algorirme paralel pencari nilai eigen dari matrix tridiagonal simetri/Ibnu Rasid	Rasid, Ibnu	1995	SK-0282
Emulasi protokol z-phase commit pada sistem basis data terdistribusi berbasis isis/ Betty Purwandari	Purwandari, Betty	1995	SK-0284
Evaluasi Penerapan Pewarisan Jamak Pada Pengimplementasian Skema Transformasisi RaRaS./Hendrato Nugroho	Nugroho, Hendranto	1995	SK-0288
Klasifikasi dan Model Matematika Untuk Kasus Rangkaian Elektronik/Suci Ratnawati	Ratnawati, Suci	1995	SK-0289
Manajer repository untuk pengembangan perangkat lunak berorientasi objek/Richard A. Kasenda	Kasenda, Richard A.	1995	SK-0286
Mesin Logika Fuzzi dan Implementasinya/ Mirna Sriredjeki	Sri Redjeki, Mirna	1995	SK-0291
Pemodelan sistem pembangkit musik interaktif, adaptif dan emosional/Budhitama Subagdja	Subagdja, Budhitama	1995	SK-0300
Pengembangan prototipe kamus elektronis juita(ke-Juita) dalam lingkungan banyak pelayan (multi-server)/ Pendi Tresna	Tresna, Pendi	1995	SK-0293
Pengenalan Suara Dengan Jaringan Neural Buatan ARTMAP/Nadiah	Nadiah	1995	SK-0290
Prototipe kernel sistem informasi geografis berbasis raster dengan struktur data quadtree/Bumi Aryani	Aryani, Bumi	1995	SK-0285
Prototipe pemeriksa tata bahasa baku bahasa Indonesia: sebuah program yang dikembangkan dengan alat bantu lex dan YACC pada sistem operasi unix/ Syandra Sari	Sari, Syandra	1995	SK-0287
Representasi kematangan proses pengembangan perangkat lunak dalam skala industri dengan menggunakan pendekatan berorientasi obyek/Dirk Pieter Siegers	Sieger, Dirk Pieter	1995	SK-0283
SBT: sistem berkas terkompres, implementasi dan analisa/Wahyu Suadi	Suadi, Wahyu	1995	SK-0295
Strategi penyusunan kamus referensi dan analisis kinerja metode pelacakan kata pada pemeriksa ejaan bahasa Indonesia/Antonius Nugroho	Nugroho, Antonius	1995	SK-0298
Studi pengenalan permukaan obyek tiga dimensi pada range image berdasarkan kurvatur mean dan gaussian/Sri Viranti	Budisayekti, Sri Viranti	1995	SK-0301
Visualisasi clustering secara hirarkis seagai alat bantu analisa data/Dwipo Setyantoro	Setyantoro, Dwipo	1995	SK-0296
Algoritma paralel untuk penggabungan/ Ahmad Sanusi	Sanusi, Ahmad	1994	SK-0269
Aplikasi dekomposisi nilai sigular untuk masalah kuadrat terkecil berkendala/ Riri Siahaan	Siahaan, Riri	1994	SK-0279
Deteksi sisi horison pada rekaman seismik dengan metode pengolah citra operator gradien/ Imron Afroni	Afroni, Imron	1994	SK-???
IMPROVER: suatu alat penguji mutasi otomatis yang dapat memberikan alternatif perbaikan terhadap kesalahan progam uji/Budi Setiadi	Setiadi, Budi	1994	SK-0281
Implementasi Metode Perancangan Partisipatif (Participatory Design) untuk Mencari Kata Perintah Berbahasa Indonesia./Riri Satria	Satria, Riri	1994	SK-0271
Implementasi prototipe pertukaran data elektronis dengan penerjemah berbasis UN/EDIFACT/Ivan Sorano Chandra	Chandra, Ivan Sorano	1994	SK-0277
Mirakle, Implementasi Algoritme Genetika Pada Sistem Pakar Analisa Keuangan/Andi Priatnakusumah	Priatnahkusumah, Andi	1994	SK-0272
Penerapan dan pengembangan perangkat lunak penelusuran sinar (Ray Tracing) rayshade pada mesin silicon graphics/Jan Setiawan	Setiawan, Jan	1994	SK-0260
Pengklasifikasi vegetasi hutan hujan tropis secara otomatis/Agung Kuswanto	Kuswnto, Agung	1994	SK-0311
Pengujian Kecocokan Representasi Icon Pada Perangkat Lunak Komputer Dengan Mental Model Pemakai Indonesia/Basar P. Sibarani	Sibarani, Basar P.	1994	SK-0275
Remote log-on untuk komputer MV/8000/ Irwan Margono	Margono, Irwan	1994	SK-0091
SIMANTAP: Simulator Jaringan Neural Artmap/Sius Wibisono	Wibisono, Sius	1994	SK-0259
SPN: Sistem Pendistribusian Usenet News/Kamin Arifin	Arifin, Kamin	1994	SK-0270
Sistem Penyaji Informasi Berbasis Jaringan Komputer Dengan Media Komunikasi Surat Elektronis/Esti E. Bernadette	Bernadette, Esti E. M	1994	SK-0276
Sistem kuratif untuk perunut sinar DKBTrace/ Bontor Parlindungan Rajagukguk	Rajagukguk, Bontor Parlindungan	1994	SK-0258
Sistem penterjemahan antar bahasa tingkat tinggi generasi keempat sebuah prototip/Widiantono, Adi	Adi, Widiantono	1994	SK-0267
Studi Eksperimen Klasifikasi Citra SAR Berdasarkan Unit Tekstur dn Statistik Lokal/Nurdi Darwis	Darwis, Nurdi	1994	SK-0273
Alat bantu case untuk programan: pembangkit kerangka program dbase IV menggunakan metode perancangan terstruktur yourdon/constantine/ Dian Irawati Nasution	Nasution, Dian Irawati	1993	SK-0265
Alternatif penyimpanan berkas tetap dalam bentuk kode menggunakan beberapa struktur pohon/Faizah Firdaus	Firdaus, Faizah	1993	SK-0268
Analisa kinerja algoritma pencari akar polinomial pada sistem multiprosesor berbasis transputer/Toga Halomoan Marpaung	Marpaung, Toga Halomoan	1993	SK-0264
Evaluasi kinerja sistem komputer paralel berbasis pertukaran pesan TransPAU/Budhie Himawan	Himawan, Budhie	1993	SK-0263
Pengembangan perangkat lunak untuk aplikasi orthodonti/ Dadan Hardianto	Hardianto, Dadan	1993	SK-0262
"Realisasi pembangkit ""custodial applications"" sebagai bagian dari wahana rekayasa perangkat lunak/Yudho Giri Sucahyo"	Sucahyo, Yudho Giri	1993	SK-0261
Replikasi berkas pada sistem terdistribusi/ Rendi Wardhana	Wardhana, Rendi	1993	SK-0253
Sistem pengamanan pesan elektronis di Unix dengan teknik kriptografi/Widjiantoro	Widjiantoro	1993	SK-0254
TransPVM: sebuah wahana pemrograman paralel pada mesin berbasis transputer/ Hendra Widjaja	Widjaja, Hendra	1993	SK-0266
Analisa Unjuk Kerja Algoritma Paralel Pencari Akar Polinomial/ R. Adila Danan Jaya	Jaya, R. Adilla Danan	1992	SK-0234
Aplikasi interpolan pada kesalahan lokal solusi persoalan syat awal persamaan diferensial biasa/ Sutara	Sutara	1992	SK-0256
Aplikasi optimisasi kode menengah pada kompilator/Gina	Gina	1992	SK-0251
FASTJOB: Fasilitas Sistem Pelayanan Job pada jaringan komputer lokal/ Nurcahman	Nurachman	1992	SK-0248
Manajemen jaringan pada jaringan komputer berbasis TCP/IP/Edwin Prijanto	Edwin Prijanto	1992	SK-0239
Otomasi penanganan jalan tol: prototip perangkat lunak pada komputer plaza/ Rina Yuliamida	Yuiamida, Rina	1992	SK-0255
PINOR: Piranti pelaksana normalisasi basis data relasional/ Sri Hastuti Ayuningsih	Ayuningsih, Sri Hastuti	1992	SK-0426
Penentuan ridge count sidik jari dengan teknik pengolahan citra	Maukar;  | Publisher: [Depok: Fasilkom UI, 1992	1992	SK-0230
Pengenalan obyek berbentuk ellips dan lingkaran pada citra digital	Adrianus F. Tumewu	1992	SK-0242
Pengolahan bahasa alami dalam pemrosesan kalimat query bahasa Indonesia	Joshua K. Djafar	1992	SK-0240
Perancangan keping tunggal untuk antarmuka manusia dari komputer/Asep Rohmat	Rahmat, Asep	1992	SK-0238
Prototipe perangkat lunak gardu masuk jalan TOL/ Indrawati	Indrawati	1992	SK-0237
SIPANDU: sistem pengelolaan disk terpadu	Arief Budiman	1992	SK-0243
Simulasi dan analisa unjuk kerja sistem otomatisasi tol/ Petrus Mursanto	Mursanto, Petrus	1992	SK-0241
Sistem antarmuka bahasa alami untuk pengaksesan basis data	Tjahjadi	1992	SK-0236
TATIX: Fasilitas admninistrasi pemakai terpadu pada jaringan lokal unix	Yerianto, Denny	1992	SK-0246
Tatik: fasilitas administrasi pemakai terpadu pada jaringan lokal unix	Denny Yerianto	1992	SK-246
Tutorix sebuah perangkat ajar berbantuan komputer untuk belajar sistem operasi unix	Fanny Angela	1992	SK-0244
Visualisasi sebaran panas dengan menggunakan persamaan diferensial parabolik/ Wahyuni Theresia	Theresia, Wahyuni	1992	SK-0250
Antarmuka clipper dan btrieve/ Untung Dwi Saptoto	Saptoto, Untung Dwi	1991	SK-0231
Deteksi gerak muka linear dengan menggunakan metode otoko newton raphsons sebagai alat komunikasi manusia dengan komputer/ Panca Putri Indrianita	Panca Putri Indrianita	1991	SK-0185
Fasilitas on-line conferencing pada jaringan komputer lokal IBM-PC dengan netbios Novell-networe/ Siswanto	Siswanto	1991	SK-0215
Mesin inferensi heuristik untuk efisiensi kerja	Chaidir Akbar Hudari	1991	SK-0235
Penerapan beberapa metode pendeteksian tepi obyek pada citra dijital/ Gito Purnomo	Purnomo, Gito	1991	SK-0179
Penerapan teknik maksimum entropy untuk pemrosesan sinyal EEG/ Agus Maulana	Maulana, Agus	1991	SK-0175
Pengenalan pola karakter secara optis pada kelompok huruf besar cetak berdasarkan metode pengenalan sifat fisik karakter 	Yuanita Rohali	1991	SK-0180
Penyambungan citra digital (mosaicking) dengan komputer mikro/ Muhammaed Syam	Syam, Muhammed	1991	SK-0178
Physigs: sebuah perangkat ajar cerdas untuk belajar hukum Newston tentang gerang	Irmawati	1991	SK-0232
Planner: Suatu Sistem Perencanaan dan Penjadwalan/ Berlina Chandra	Berlina Chandra	1991	SK-0233
Sistem dokumentasi program otomatis (SDPO)/ Prihandoko	Prihandoko	1991	SK-0182
Sistem pakar pendeteksi pola: mesin inferensi untuk pengenalan pola sintaktik/ Amin Kurniawan	Kurniawan, Amin	1991	SK-0181
Sistem pakar penganalisa keuangan	Bagus Pribadi	1991	SK-0214
Sistem penghitung tingkat kerumitan	Nurul Aini	1991	SK-0183
Sistem penghitungan unjuk kerja 	Hans Patrick H, Widjaja	1991	SK-0227
Vektorisasi citra raster menjadi citra vektor/ Jeffrey Sanjaya	Sanjaya, Jeffrey	1991	SK-0213
Analisa plat penerus dengan cara panel tertentu/ Udayana Wirya	Wirya, Udayana	1990	SK-0126
Dbserve: sebuah database server pada jaringan komputer berbasis pesan/ Frenky Jonathan Palit	Palit, Frenky Jonathan	1990	SK-0173
Determinan matrik 5-diagonal toeplitz dan kaitannya dengan polinomial chebyshev jenis kedua/ Benny Nugrahadi	Nugrahadi, Benny	1990	SK-0174
Klasifikasi sidik jari otomatis dengan teknik pengenalan pola/ Abdul Hakim Ghanem	Ghanem, Abdul Hakim	1990	SK-0184
Perangkat lunak device driver amulex untuk sco-xenix/ Fanina	Fanina	1990	SK-0176
Simulasi numerik vertical seismic profiling dengan metode reflektivitas fuchs dan mueller/ Suwarno	Suwarno	1990	SK-0155
P-forum : Kalawarta pribadi pada komputer mikro/ Djony Tanuwidjaya	Tanuwidjaja, Djony	1989	SK-0222
P-forum: kalawarta pribadi pada komputer mikro/ Djony Tanuwijaya	Tanuwidjaja, Djony	1989	SK-0210
Pembuatan perakit silang Z80 sebagai alat bantu pengembangan program MPF I/ Tri Winarko	Winarko, Tri	1989	SK-0217
Pembuktian teorema dengan unit binary resolution/ Musanto Yudoyoko	Yudoyoko, Mursanto	1989	SK-0186
Pembuktian teorema propagate and divide pada logika proposisi/ Sjarifuddin Amin	Amin, Sjarifuddin	1989	SK-0187
Sistem praprosesor untuk emulasi terminal/ Asril R. Malasan	Malasan, Asril R.	1989	SK-0172
"pe: penyunting layar model ""WS"" pada sistem operasin unix/ Pudja Unggul Kartiman"	Kartiman, Pudja Unggul	1989	SK-0211
Analisa ekstraksi ciri tekstur dengan metode matriks ketergantungan ko-okurensi tingkat keabuan/ XYZQUO	XYZQUO	1988	SK-0216
Digitizing tablet suatu alat bantu komputer grafik/ Liem Goan an	Goan An, Liem	1988	SK-0208
Emulasi komputer risc II dengan prolog/ Risargati	Risargati	1988	SK-0074
Pembentukan tabel parsing grammar LR(k)/ Gator Herliyanto	Herliyanto, Gatot	1988	SK-0039
Pengembangan perangkat lunak antarmuka untuk mensimulasikan rancangan VLSI dalam format VHDL/ Sigit Arnanto	Arnanto, Sigit	1988	SK-0097
Pengembangan piranti pemeriksa kaidah rancang untuk perancangan very large scale integration circuit (VLSIC)/ Ridwan Rafael Chasspuri	Chaspuri, Ridwan Rafael	1988	SK-0149
Pengolahan citra digital dengan metode filter homomorphic/ Rusli Amril	Amril, Rusli	1988	SK-0223
Penyelesaian masalah transient konduksi panas pada sebuah plat dengan metode elemen hingga/ Guntur Moh. Widjaja	Moh. Guntur Widjaja	1988	SK-0042
Penyusunan basis data untuk sistem ahli: minisasi aljabar boolean/ Johannes Filandow	Filandow, Johannes	1988	SK-0207
Perancangan rangkaian terpadu untuk deteksi posisi arah, dan kecepatan putaran motor/ Harum Hambartini	Hambartini, Harum	1988	SK-0219
Perancangan rangkaian terpadu untuk deteksi posisi, arah, dan kecepatan putaran motor	Harum Hambartini	1988	SK-0142
Perancangan sistem kendali berbantuan komputer/ Noordin Salim	Salim, Noodin	1988	SK-???
Rancangan chip untuk antarmuka telex: fungsi antarmuka jaringan/ Suryaningrum Kartikawati	Kartikawati, Suryaningrum	1988	SK-0101
Aplikasi sistem basis data deduktif menggunakan prolog/ Nurwendo Haricahyadi	Haricahyadi, Nurwendo	1987	SK-0012
Beberapa metode summability dan perhitungan pada deret fourier/ Misfaruddin	Misfaruddin	1987	SK-0167
Drazin invers/ Eva Zulfa Nailufar	Naifular, Eva Zulfa	1987	SK-0018
Eksekusi paralel operator relasi SMBDR/ Manonton Butar-butar	Butabutar, Manonton	1987	SK-???
Flip-flop register dan unit memori/ Rosita	Rosita	1987	SK-0020
Godel numbering bagi  string graph dan program/ Ernastuti	Ernastuti	1987	SK-0022
Heuristic search sebagai alternatif pelacakan dan implementasinya dalam prolog untuk aplikasi theorea proving/ Syarif Abdat	Abdat, Syarif	1987	SK-0023
"Interface I/O ser-paralel mikrokomputer apple II plus dengan instrumen mossbauer ""Promeda""/ Prawito"	Prawito	1987	SK-0144
Kumunikasi radip paket	Nahari Mursid	1987	SK-0203
MX/2: sistem ahli perancang rangkaian lojik dengan kemampuan grafis/ Hendro Wantoro	Wantoro, Hendro	1987	SK-0073
Mesin inferensi pada sistem pendukung pengambilan keputusan untuk pendidikan tinggi (SPPK-PT)	Sutanto, Herry	1987	SK-0130
Panampilan struktur data dinamis pada tingkt konseptual dengan bahasa C/ Zulhelfi	zulhelfi	1987	SK-???
Parsing grammar LL(k)/ Ratna Iriani	Iriani, Ratna	1987	SK-0038
Penerapan fasilitas forum diskusi elektronis pada jaringan antar Universitas UNInet/ Reny Luswita	Luswita, Reny	1987	SK-0111
Pengembangan perangkat kompilasi VHDL (VHSIC Hardware description language) untuk rangkaian VLSI teknologi NMOS/ Rachma Dewi Bardijan	Bardijan, Rachma Dewi	1987	SK-0212
Pengembangan perangkat lunak FTA berbasis UUCP diatas lapisan Xodiac (X.25) pada AOS/VS/ Budi Wahyu Jati	Jati, Budi Wahyu	1987	SK-0108
Pengembangan perangkat lunak antarmuka antara jaringan telex dengan jaringan komputer/ Bareb Risanto	Risanto, Bareb	1987	SK-0095
Pengembangan perangkat lunak komunikasi daa UUCP pada sistem operasi AOS/VS	Ira Hanggoro Maruta	1987	SK-???
Pengembangan pesan elektronis diatas lapisan X.25 pada sistem operasi AOS/VS/ Pratiwi Widjiastuti	Widjiastuti	1987	SK-0109
Pengembangan piranti penjaluran untuk rancangan elektronik mikro/ Widodo	Widodo	1987	SK-0220
Pengembangan sarana kemudahan perangkat-lunak di berbagai jenis komputer	Liem Kin Tet	1987	SK-0202
Pengembangan sistem penanganan pesan dengan bakuan X.400: penerapan MTA pada AOS/VS	Tanto, Wignyo	1987	SK-0115
Pengembangan sistem penanganan pesan dengan bakuan X.400: penerapan UA pada AOS/VS/ Susana Lilik W.	Lilik W., Susana	1987	SK-0110
Perancangan dan implementasi program kumunikasi untuk IBM PC/ Wahyu Catur Wibowo	Wibowo, Wahyu Catur	1987	SK-???
Proses penelusuran eksekusi fakta di dalam interpreter portable prolog/ Edwin Djoko Sarwono	Sarwono, Edwin Djoko	1987	SK-0050
Stabilitas solusi elemen hingga dari time-dependent problem pada persamaan diferensial parsial diruang dimensi dua/ Frederik Moses Poyk	Poyk, Frederik Moses	1987	SK-0057
Transformasi grafik dimensi 3 pada layar dimensi 2/ Ronny Amir	Amir, Ronny	1987	SK-0067
Analisa algoritma travesal pada treaded binary tree/ Imron Wahyuni Z.	Imran, Wahyuni Z.	1986	SK-0009
Aplikasi teori group dalma penjualan dengan waktu minimal/ Artini Sukotjo	Sukotjo, Artini	1986	SK-0013
Arus maksimum pada jaringan transformasi/ Sri Rubiyati	Rubiyanti, Sri	1986	SK-0014
C-Soka: penggunaan bahasa tingkat tinggi dalam disain sistem operasi komputer mikro/ Handoko Dipo	Dipo, Handoko	1986	SK-0195
Evaluasi metode analisis jawaban atas pertanyaan terbuka untuk sistem ecal dan implementasinya/ Herry Sutanto	Sutanto, Herry	1986	SK-0136
Fasilitas pemindahan berkas pada sistem AOS/VS/ Benediktus Nugroho Budipriyanto	Budipriyanto, Benediktus Nugroho	1986	SK-0133
Fasilitas pemindahan berkas pada sistem operasi unix/ Ahmad Bambang	Bambnag, Ahmad	1986	SK-???
Implementasi algoritma derajat minimal dengan quotient graph/ Eko Hadipriyono	Hadipriyono, Eko	1986	SK-0143
Implementasi pemindahan dana elektronis di Indonesia/ Johan Baharuddin	Baharuddin, Johan	1986	SK-0197
Integral polsson dan aplikasinya di dalam persoalan clirichlet dan personal newman/ Adrian Ausri	Ausri, Adrian	1986	SK-0025
Metode conjugate gradient dengan blok preconditioning chalesky tak lengkap/ Helmi Tang	Tang, Helmi	1986	SK-0035
Metode prediktor-korektor untuk penyelesaian persoalan syarat awal persamaan differensial biasa order baru/ Sulistyo Puspitodjati	Puspitodjati, Sulistyo	1986	SK-0034
Metode transformasi elementer tree untuk menghasilkan semua spanning-tree yang berbeda dari suatu graph-lengkap/ Rina Lestari	Lestari, Rina	1986	SK-0036
Penelitian eksperimental tentang korelasi pengaturan air pendingin dengan temperatur kerja motor otto V.C.R./ Asrin R. Haznam	Haznam, Asrin R.	1986	SK-0162
Penerapan metoda analisa komponen utama untuk reduksi kanal data dan perbaikan citra/ Nur Gunawan Sastranegara	Sastranegara, Nur Gunawan	1986	SK-0102
Penerapan paket komunikasi antar unix pada jaringan uninet tahap pertama/ Benny Somali	Somali, Benny	1986	SK-0112
Pengaruh pendidikan, usia nikah pertama dan pekerjaan sejak menikah pada ferlitas di DKI Jakarta/ Roshariani Rasjad	Rasjad, Roshariani	1986	SK-0146
Pengaturan arus lalu lintas minyak dengan pipa di terminal dumai/ Harry Patuan Panjaitan	Panjaitan, Harry Patuan	1986	SK-0076
Pengembangan akses basis data melalui jaringan telekomunikasi di Indonesia/ Melly Hidayat	Hidayat, Melly	1986	SK-0199
Pengembangan dan pemanfaatan secara terintegrasi  jasa-jasa dalam jaringan UI-NET/ Josep F.P. Luhukay 	Antonius	1986	SK-0105
Pengembangan lapisan-lapisan protokol osi di atas lapisan protokol X.25/ Martinus Tjia	Tjia, Martinus	1986	SK-0198
Pengembangan pelayanan kalawarta komputer/ Anak Agung Putri Ratna	Ratna, Anak Agung Putri	1986	SK-0094
Pengembangan penyunting grafis untuk perancangan very large scale integration circuit (VSLSIC)	Dadang Gunawan	1986	SK-???
Pengembangan perangkat simulasi rangkaian listrik SPICE-26 pada komputer MC/8000	Tonny Ismantara	1986	SK-0200
Pengembangan perangkat simulasi rangkaian listrik spice-20 pada komputer MV/8000/ Tonny Ismantara	Ismantara, Tonny	1986	SK-0104
Penggunaan splines untuk perencanaan geometrik jalan raya/ Ricardo Muliano T.	Muliano T, Ricardo	1986	SK-0080
Perencanaan model terminal terminal terminal terpadu untuk bis dan kereta api: model stasiun Jatinegara/ Kabul Subiandono	Subiandono, Kabul	1986	SK-0086
Petunjuk teknis C-layan program pendukung perangkat lunak print server pada UI-Net/ Afwarman	Afwarman	1986	SK-0194
Rancangan antarmuka bagi interkoneksi jaringan telex dengan jaringan komputer/ Freddy Simanjuntak	Simanjuntak, Freddy	1986	SK-0100
Restorasi citra digital dengan metoda aljabar linier: perbandingan metoda dekomposisi nilai sigular dengan metoda proyeksi iteraktif/F.X. Nursalim Hadi	Hadi, F.X. Nursalim	1986	SK-0228
Sistem pengukur suhu instrumented fuel element (IFE) berdasarkan mikroprosesor/ I. Made Sudjana	Sudjana, I Made	1986	SK-0055
Studi perbandingan antara komunikasi melalui satelit dan komunikasi melalui serat optik di Indonesia/ I. Gede Wikrama Putra	Putra, I. Gede Wikrama	1986	SK-0196
Studi tentang hubungan pola seleksi dengan prestasi belajar mahasiswa di FMIPA-UI(Studi kasus untuk angkatan 80-84)/ Dian Lestari	Lestari, Dian	1986	SK-0059
Suatu tinjauan tentang problema - problema NP/ Iman Santoso	Santoso, Iman	1986	SK-0064
Verifikasi program Loop/ Bevina Debjwiandra Handari	Handari, Bevina Debjwiandra	1986	SK-0068
Verifikasi program rekursif/ Gatot Fatwanto H.	Fatwanto H, Gatot	1986	SK-0148
Algoritma QR	Rustam, Zuherman	1985	SK-0006
Algoritma QZ/ A. Atono	Antono, A.	1985	SK-0154
Algoritma perhitungan reciplocal dan modular bagi integer dan polinomial integer/ Diah K. Dwisaptarini	Diah K, Dwisaptaini	1985	SK-0005
Analisa perbandingan waktu mencari pada perekam data piringan untuk lokasi directory yang berbeda/ R. Poespawati	Poespawati, R.	1985	SK-0191
Aplikasi mikroprosesor 8085 untuk pengetahuan motor stepper/ Muhammadi	Budianto, Erwin	1985	SK-0093
Beberapa aspek persamaan integral nonlinear/ Hardyaningwati	Hardyaningwati	1985	SK-0016
Connectivity dalam matroid/ Bermadine Indriasmini	Indriasmini, Bermadine	1985	SK-0017
Desain dan pengembangan jaringan data base access di Indonesia/ Zul'azmi Sibuea	Sibuea, Zul'Azmi	1985	SK-0193
Eugenvalue dari graph dan multi-graph/ Chamili	Chamili	1985	SK-0019
Fungsi hypergeometric/ Indrati	Indrati	1985	SK-0021
Hubungan antara teori ukuran dan teori probabilites/ Indra Hadi	Hadi, Indra	1985	SK-0024
Implementasi protokol X.25 pada jaringan komunikasi data/ Jacks MP. Hutabarat	Hutabarat, Jacks MP	1985	SK-0189
Karakterisasi dari graph blok dan tiga bentuk perluasannya/ Muchsinah	Muchsinah	1985	SK-0027
Metode broyden untuk penyelesaian persamaan nonlinear/ Indrika Mia	Indrika, Mia	1985	SK-0033
Metode garis lurus untuk penyelesaian persamaan diferensial parsial/ Suwandi	Suwandi	1985	SK-0037
Pemanfaatan hot rolled sheet sebagai lapis permukaan konstruksi perkerasan lentur/ Batara Arifin	Arifin, Batara	1985	SK-0089
Penerapan erangkat kompilasi-silang modula-2 pada MV/8000/ Adhi Yuniarto L.Y.	Yuniarto L.Y, Adhi	1985	SK-0099
Penyelesaian masalah transient konduksi panas pada sebuah plat dengan metode elemen hingga/ Moh. Guntur Wijayanto	Widjayanto, Moh. Guntur	1985	SK-0043
Penyelesaian persamaan poisson dengan metoda finite difference dan multi-grid/ Heru Suhartanto	Suhartanto, Heru	1985	SK-0159
Perancangan sistem multiprocessor dengan struktur private and global memory	Budiardjo, Eko Kuswardono	1985	SK-0128
Perangkat lunak untuk penyelesaian analisa traffic assignment: studi kasus kota Ujung Pandang	Deddy Arief	1985	SK-0083
Perbandingan kemampuan fungsional dari lan dan PBX sebagai sarana komunikasi sistem otomatisasi kantor/ Jufrinov Tanjung	Tanjung, Jufrinov	1985	SK-0071
Perbandingan metode iterasi jacobl, gauss seidel dan successive over-relaxation daam penyelesaian  persamaan diferensial parsial type elliptik/ Daltur Lukas Redakasiang	Rendakasing, Daltur Lukas	1985	SK-0044
Perbedaan beberapa sifat tanah podsolik yang disawahkan dan tidak disawahkan di tiga tempat serta klasifikasinya menurut taksonomi tanah/ Dana Indra Sensuse	Sensuse, Dana Indra	1985	SK-???
Perhitungan dosis radiasi lingkungan dengna metode monte carlo adjoint/ Jeniputri Ali	Ali, Juniputri	1985	SK-0045
Persamaan differensial parsial linear order dua tipe parabolik dan transformasi affine/ Dani Pradana K.	Pradana K, Dani	1985	SK-0047
Persoalan undeci doble pada psys correspondence problem (PCP)/ Rachmat Karyanda S.	Karyanda S, Rachmat	1985	SK-0048
Program dinamik/ Tarzan Basaruddin	Basaruddin, Tarzan	1985	SK-0138
Reaktif komputer menggunakan mikroprocessor MC 6802/ Syafedi	Syafedi	1985	SK-0051
Sarana laboratorium komputer mikro percobaan-percobaan lanjut/ Luki Dewayani	Dewayani, Luki;  | Publisher: Jakarta: FT Elektro, 1985 | Call Number: SK-0190 sama NO. 0165	1985	SK-0190
Sarana laboratorium komputer mikro: percobaan-percobaan dasar/ Riyeni Widya Rabain	Rabain, Riyeni Widya	1985	SK-0192
Simulasi komputer steam balance sistem uap kilang LNG bontang dan aplikasinya dalam analisa kejadian surge/ Wigandi Kurniawan	Kurniawan, Wigandi	1985	SK-???
Studi model migrasi data seismik dengan pergeseran fasa tambah interpolasi/ Darwin Silalahi	Silalahi, Darwin	1985	SK-0158
Suatu tinjauan mengenai aplikasi struktur tree/ Usa Sutrisna	Sutrisna, Usa	1985	SK-0060
Suatu tinjauan mengenai optimalisasi bangun binary search/ Jullysava C. Aziz	Aziz, Jullysava C.	1985	SK-0061
Suatu tinjauan tentang masalah path terpendek/ R. Yugo K. Isal	Isal, R. Yugo Kartono	1985	SK-0063
Suatu tinjauan tentang subset fuzzy dan aplikasinya/ Romli	Romli	1985	SK-0065
Adaptive differential PCM coder untuk transmisi sinyal telepon/ Harmon	Harmon	1984	SK-0103
Algoritma cuthill dan beberapa variasinya/ Kartini Slamet	Slamet, Kartini	1984	SK-0003
Analisa pola angkutan tebu pada PD Tasikmadu XV (Persero)/ Djoni Widjanarko Kridarso	Kridarso, Djoni Widjanarko	1984	SK-0001
Analisis robot CS-111/ Machmudin Junus	Junus, Machmudin	1984	SK-???
Aplikasi fungsi bessel dalam persoalan strum honvile/ Adi Kresno	Kresno, Adi	1984	SK-0010
Aplikasi gaji pegawai & pergudangan pada bidang perhotelan	Ari Bintoro	1984	SK-0141
Aplikasi mikrokomputer CBM untuk kalibrasi digital voltmeter/ Venny Zano	Zano, Venny	1984	SK-0122
Aplikasi paket switching untuk telekomunikasi internasional di Indonesia/ Marwan	Marwan	1984	SK-0072
Beberapa aspek dari deret fourier/ Benny Prabowosunu	Prabonosunu, Benny	1984	SK-0015
Implementasi operasi ekstraksi relasi pada sistem relasional/ Antonius Padua Hardhono	Hardhoko, Antonius Padua	1984	SK-0131
Inertial navigation system/ Sutjianto	Sutjianto	1984	SK-0124
Kemudahan akses dan pengawasan sumberdaya pada jaringan UI-NET/ Moch. Budiman Tamimi	Tamimi, Moch Budiman	1984	SK-0188
MIKAS: sebuah sistem pemindahan berkas pada jaringan lokal UI.NET/ Endang Ripmiatim	Ripmiatin, Endang	1984	SK-0106
MX/1 sistem ahli perancang  multiplekser/ Ismed D.S. Hartanto	Hartanto, Ismed D.S	1984	SK-0221
Penaksiran titik parameter dan keandalan untuk distribusi eksponensial dua parameter dengan penghampiran bayes/ Herman	Herman	1984	SK-0137
Penentuan ciri tekstur dengan metode NGLDM/ Jeffry A. Wattimena	Wattimena, Jeffry A.	1984	SK-0113
Pengolahan isyarat digital dengan MPF-1/ RM. Samik Ibrahim	Ibrahim, R.M. Samik	1984	SK-0225
Penyelesaian persamaan integral fredholm tak linier dengan metode beda hingga dan metode iterasi/ Widijanto Satyo Nugroho	Nugroho, Widijanto Satyo	1984	SK-0132
Perhitungan plat beton bertulang orthotropic dengan cara finite element	Halim, Udayasuddhata	1984	SK-0087
Perluasan aljabar dan perluasan transcedental dari suatu field/ Kiki Aryanti	Aryanti, Kiki	1984	SK-0046
Pusat pelayanan akademis ITB/ Saiful Basri Ridwan	Ridwan, Saiful Basri	1984	SK-0226
Radar homing rudal A.G.M./ Basudi Purwanto	Purwanto, Basuki	1984	SK-0125
Sarana laboratorium rancangan lojik: percobaan-percobaan dasar/ Erwin Ruswinartiek	Ruswinartiek, Erwin	1984	SK-0088
Sarana laboratorium rancangan lojik: percobaan-percobaan lanjut/ Lista Dewi S.	Dewi S, Lista	1984	SK-0118
Sistem kendali kecepatan dengan pengendali proposional, integral dan berivativ/ Waseso Segoro	Segoro, Waseso	1984	SK-0090
Sistem telemedika untuk kota metopolitan/ Rustaman	Rustaman	1984	SK-0123
Suatu aplikasi dari teorema residu pada integral dan deret/ Mulyono	Mulyono	1984	SK-0160
Suatu struktur data untuk sistem relasional/ Rostina Zainuddin	Zainuddin, Rostina	1984	SK-0127
Suatu tinjauan tentang context-tree grammar/ Bambang Redjeki Suryosumanto	Suryosumanto,  Bambang Redjeki	1984	SK-0062
Analisa obyektif medan angin dan penghitungan stream function di wilayah Indonesia dan sekitarnya/ Khalif	Khalif	1983	SK-0218
Analisa penerapan partial directory dengan associative memory pada sistem translasi alamat/ Andreas T. Tedja	Tedja, Andreas T.	1983	SK-0085
Design digital microwave Jakarta-Jatiluhur/ Dadang Gunawan	Gunawan, Dadang	1983	SK-0107
Kemungkinan penggunaan polipropelene hasil pertanian  sebagai semi konduktor/ Krisnawati Ridwan	Ridwan, Krisnawati	1983	SK-0028
Memori cache: beberapa faktor yang mempengaruhi performancenya/ Ina Lisyosuputro	Listyosuputro, Ina	1983	SK-0117
Rancangan chip untuk antarmuka telex: fungsi kontrol/ Boedirahardjo S.	S, Boedirahardjo	1983	SK-0096
Simulasi sistem kendali hidrolis/ Augi Saputra Setiawan	Setiawan, Augi Saputra	1983	SK-0081
Simulasi sistem kendali orde dua dengan waktu optimal/ Sri Mulyanti	Mulyanti, Sri	1983	SK-0098
Tracking satelit/ Hajar Hadi	Hadi, Hajar	1983	SK-0114
Charge coupled devices (CCD)/ Sianita Widjaja	Widjaja, Sianita	1982	SK-0120
Interpolasi pembicaraan secara digital pada sistem transmisi TDMA/ Rythme Aulia	Aulia, Rythme	1982	SK-???
Mechester coding dengan predistorsi/ Yunita Soemantri	Soemantri, Yunita	1982	SK-0079
Pemakaian mikrokomputer CBM 4032 untuk menentukan konsentrasi bakteri dalam fermentasi alkohol menjadi asam cuka/ Hermanto Riawan	Riawan, Hermanto	1982	SK-0121
Pemilihan ADC dalam penggunaan mikroprosesor untuk kromatrograp gas/ Hamidah Tri Irianti	Tri Irianti, Hamidah	1982	SK-0119
Penyadian hamming/ Budi Giarto	Giarto, Budi	1982	SK-0077
Penyandian convolutional/ Erdefi Rakun	Rakun, Erdefi	1982	SK-0092
Relational data base pada IBM S/38/ Santoto, Tri Djoko	Santoso, Tri Djoko	1982	SK-0052
Teknologi gelembung magnetik/ Fanny Santosa	Santosa, Fanny	1982	SK-0116
Otomatisasi perpustakaan dalam bidang penyimpanan dan pencarian kembali informasi di PIPE, LPEM, FEUI/ Supriyanto Sudiharjono	Sudiharjono, Supriyanto	1981	SK-0070
Analisa spatial dan regional stasiun pencatat curah hujan di pulau jawa berdasarkan data curah hujan toal tahunan dari tahun 1951-1975/ Adi Sagitiwarih	Sagitiwarih, Adi	1980	SK-0008
Keputusan management sehubungan dengan maslaah-masalah khusus ditinjau dari konsep biaya relevan aplikasi linear/ Veronika Rahardja	Rahardja, Veronika	1980	SK-0002
Taksiran regresi linier dalam simple random sampling/ Ratu Suftiati	Suftiati, Ratu	1980	SK-0147
Interprestasi  data V.E.S (Vertikal electric sounding) dengan metode kedepan/ A.B. Julianto	Julianto, A.B.	1979	SK-0026
Prinsip maximum dalam persamaan differensial/ Sri Mardiati	Mardiyati, Sri	1979	SK-???
Sistim administrasi kelas IBM Indonesia/ Duddy Dwi	Dwi, Duddy	1979	SK-0054
Algoritma fast fourier transform/ Sumantri Slamet Santoso	Santoso, Sumantri Slamet	1978	SK-0004
Aplikasi komputer pada data refraksi seismik model bumi berlapis-lapis miring/ Agustinus Harsono	Harsono, Agustinus	1978	SK-???
Kesetaraan pendefinisian - pendefinisian/ Sapto Trilaksono 	Sapto, Trilaksono	1978	SK-0029
M/M/I & M/M/S dalam queueing theory/ Nachrowi	Nachrowi	1978	SK-0032
Simulasi sistem stochastik yang diskrit dengan FPSS/ Nachrowi	Nachrowi	1978	SK-0053
Solusi dari persamaan non linear/ Sapto Trilaksono	Trilaksono, Sapto	1978	SK-0066
Ketidaksamaan linear dan teorema-teorema alternative/ Sumantri Slamet Iman Santoso	Santoso, Sumantri Salamet Iman	1977	SK-0161
Membuat model matematika dengan regresi berganda/ Muljana Soekarni	Muljana, Soekarni	1977	SK-0031
Studi tentang rekayasa dan verifikasi rigor menggunakan SDL dalam perancangan manajemen kegagalan sistem/ Mephri	Mephri	1977	SK-0343
Usaha komputerisasi dan anxiety sebagai salah satu akibat sampingnya/ A.Y. Sasi Hermanto	Hermanto, A.Y. Sasi	1977	SK-0166
AJUDAN: Alat bantu dalam aktifitas antar mesin/ Yuwono Hadi	Hadi, Yuwono	0	SK-0249
Analisa komponen dan analisa faktor/ Sudarsono	Sudarsono	0	SK-0007
Analisa masalah model bisnis B2B serta perancangan prototipe sistem B2B/ Sandy Poerwadie H.	Poerwadie H, Sandy	0	SK-0586
Analisis peran knowledge management infrastructures dalam mendukung knowledge management processess organisasi: studi kasus PT XL. Axiata Tbk.	Ida Ayu Kadek Trisnanty	0	SK-1128
Emulasi protokol 2-phase commit pada jaringan basis data terdistribusi/Muhammad Kadarullah	Kadarullah, Muhammad	0	SK-0247
Evaluasi Pemilihan Komponen Arsitektur terhadap kinerja Mikroprosessor Bus Tunggal	Andreas Febrian	0	SK-0695
Evaluasi dan pemeringkatan situs web e-government pemerintah daerah di indonesia	Dori Gusvawijaya	0	SK-1091
Faktor yang mempengaruhi kesuksesan penerapan pair programming dalam meningkatkan pemahaman konsep pemrograman mahasiswa Fasilkom UI	Sari Nursita	0	SK-0602
Implementasi XML web service dan xpath query pada pengembangan sistem basis data tersebar multi produk/ Nur Andriansyah	Nur Andriansyah	0	SK-0567
Implementasi arsitektur manajemen jaringan terdistribusi berbasis protokol SNmp menggunakan java aglet/ Setiawan Jati	Jati Setiawan	0	SK-0537
Implementasi perluasan query, fitur average distance weight dan cosine similarity untuk meningkatkan kinerja sistem tanya jawab	Yolanda Sjafrizal	0	SK-1125
Implementasi prototipe lingkungan belajar adaptif berbasis web/ Mukhlisoh Urfah	Urfah, Mukhlisoh	0	SK-0583
Implementasi sistem pengendalian revisi pada komputer MV/8000	Aviantoro  Yudihariadi	0	SK-0229
Integrasi Metascheduler GRIDWAY pada lingkungan Komputasi GRID FASILKOM UI	Abdurrasyid Mujahid	0	SK-0696
Klasifikasi Otomasi Lagu-lagu Daerah Indonesia menggunakan Metode Statistik/ Nur Indah	Nur Indah	0	SK-0604
Kolaborasi antara OSGI framework dengan teknologi jini dan home network system/ Shanti Andriyanti	Andriyanti, Shanti	0	SK-0526
Konversi sistem berorientasi objek menjadi software product line dengan abstract behavioral specification delta modeling	Ricky Timothy Gultom	0	SK-1126
Memori chache: beberapa faktor yang mempengaruhi performancenya/ Ina Listyosuputro	Listyosuputro, Ina	0	SK-0177
Metode frobenius untuk mencari solusi persamaan diferensial linear order dua/ Siti Aminah T.	Aminah T, Siti	0	SK-0252
Pelacakan heuristic pada algoritma A untuk masalah 8-puzzle pengkajian & pengamatan	Adrian Wicaksana	0	SK-0140
Pembangkit skema basisdata relasional dalam pemodelan sistem berorientasi objek/Hestina Sinaga	Sinaga, Hestina	0	SK-0280
Pembuatan layanan pada jaringan telepon intelligent network dengan pendekatan berorientasi-obyek/Wishnu P. Moeliodihardjo	Moeliodihardjo, Wishnu P.	0	SK-0303
Penerapan algoritma learning vector quantization dalam sistem pengenalan sudut pandang dan wajah 3D dengan mengaplikasikan algoritma genetika untuk penentuan ruang ciri optimal pada ruang eigen	Dewi Khaeirani	0	SK-0568
Penerapan dan pengembangan perangkat lunak penelusuran sinar (ray tracing) Ray shade pada mesin silicon graphics/Jan Setyawan	Setyawan, Jan	0	SK-260
Penggunaan jaringan hibrida PB-SKNC untuk mengenali data aroma 2 campuran dan aroma 3 campuran	Chafid Ahmad	0	SK-0467
Pengukuran kinerja proxy cache dengan metode eksplorasi sederhana/ Rahmawati Zulfa	Zulfa, Rahmawati	0	SK-0488
Perancangan ontologi user-model untuk pengembangan sistem personalized e-learning berbasis semantic web	Octo Alexander	0	SK-797
Perbandingan ranging antara algoritme single vision dan stereovision	Elan	0	SK-0656
Resolusi koreferensi menggunakan metode association rules	Nasrullah	0	SK-0609
Simulasi paralel pada model erew  SIMD untuk algoritma lintasan terpendek dari DIJKSTRA/ Tjahjono Teguh	Tjahjono, Teguh	0	SK-0257
Sistem ahli untuk diagnosis kerusakan alat/ Arianta	Arinta	0	SK-0206
Strategi pemilihan kalimat sebagai basis pengindeksan dokumen/ TH. Dwi Rinawati	Rinawati, TH. Dwi	0	SK-0392
Studi eksperimen klasifikasi citra SAR  berdasarkan matrik coocurence dan statistik lokal/ Mastur R. Muhammad	Mastur R., Muhammad	0	SK-0274
Studi pengenalan wajah 2D dengan JNB propagasai balik dioptimasi menggunakan algoritma genetika untuk data dengan feature kedalaman/ Kusuma Dewi	Dewi, Kusuma	0	SK-0544
Uji coba penggunaan session initiation protocol (SIP) untuk  komunikasi antara bluetooth enabled connected limited device dengan based network/ Adhityo Priyambodo	Adhityo Priyambodo	0	SK-0598
Visualisasi persamaan gelombang air dangkal pada personal iris dengan menggunakan metode implisit berubah arah/Ferry Sihombing	Sihombing, Ferry	0	SK-0245
pencarian kata berimbuhan pada kamus besar bahasa Indonesia dengan menggunakan algoritma stemming/ Neil Edwin Siregar	Siregar, Neil Edwin	0	SK-0297
